word,up,down,total,polar_score,polarity
순기능/NNG,11,19,30,0.5247467894831536,Dovish
유럽의회/NNG,17,41,58,0.3758164368138772,Dovish
건국/NNG,12,20,32,0.5438284909189046,Dovish
금/NNG;가격/NNG;오르/VV,7,17,24,0.37321563102277766,Dovish
용적률/NNG,29,83,112,0.3166872738282779,Dovish
호호/MAG,16,25,41,0.5800837236468316,Dovish
영치/NNG,2,15,17,0.1208507757597566,Dovish
일괄/NNG,37,48,85,0.6986685473610927,Dovish
캐캐캐/MAG,10,34,44,0.26658259358769837,Dovish
예상/NNG;치였/VV;증가/NNG,3,23,26,0.11822358498237058,Dovish
성수기/NNG,16,28,44,0.5179318961132426,Dovish
더해져/VV,57,68,125,0.7597603917249404,Dovish
시스템/NNG;위험/NNG;확대/NNG,8,11,19,0.6591860495986723,Dovish
단기/NNG;금리/NNG;안정/NNG,10,14,24,0.6474148701415533,Dovish
경이/NNG,9,12,21,0.6797856136486309,Dovish
경영전략/NNG,12,15,27,0.7251046545585396,Dovish
의외/NNG,33,41,74,0.7295260244034087,Dovish
클린에너지/NNG,7,20,27,0.31723328636936104,Dovish
소맥/NNG,28,35,63,0.7251046545585396,Dovish
유동성/NNG;우려/NNG,23,32,55,0.6514612130799379,Dovish
대위변제/NNG,22,36,58,0.5538993888988843,Dovish
금조/NNG,13,21,34,0.5610928874560127,Dovish
채권스왑/NNG,143,185,328,0.7006078756883187,Dovish
연고점/NNG;높/VV,6,11,17,0.49438953719900425,Dovish
호피/NNG,7,18,25,0.3524814292992901,Dovish
불안/NNG;조짐/NNG,7,16,23,0.3965416079617013,Dovish
절대/MAG;금리/NNG;높/VA,12,20,32,0.5438284909189046,Dovish
무릅쓰/VV,4,13,17,0.2788864055994383,Dovish
학학/NNG,12,18,30,0.604253878798783,Dovish
장단기스프레드/NNG;확대/NNG,60,76,136,0.715563803840664,Dovish
포커/NNG,3,29,32,0.09376353291705251,Dovish
호응/NNG,22,28,50,0.7121563571557085,Dovish
엿보이/VV,6,19,25,0.2862255215362656,Dovish
비록/MAG,111,145,256,0.6938501435861887,Dovish
중고/NNG,26,35,61,0.6733114649472153,Dovish
인플레이션/NNG;견조/NNG,9,11,20,0.7415843057985064,Dovish
성적표/NNG,26,38,64,0.6201552966619088,Dovish
금리/NNG;상승/NNG;충격/NNG,5,14,19,0.32370743507077665,Dovish
재정/NNG;적자/NNG,76,97,173,0.7101540431243428,Dovish
전망/NNG;금리/NNG;하락/NNG,15,19,34,0.715563803840664,Dovish
응할/VV,5,12,17,0.3776586742492394,Dovish
공급/NNG;우려/NNG,27,33,60,0.7415843057985064,Dovish
물가/NNG;안정/NNG;목표/NNG;하단/NNG,6,12,18,0.4531904090990872,Dovish
주봉/NNG,18,26,44,0.6274944125987362,Dovish
경기/NNG;지표/NNG;호조/NNG,7,10,17,0.6344665727387221,Dovish
기대/NNG;하향/NNG,10,12,22,0.7553173484984788,Dovish
순매수우위/NNG,11,15,26,0.6646792666786613,Dovish
뒤따라/VV,10,12,22,0.7553173484984788,Dovish
미래/NNG,718,1031,1749,0.6312137996763232,Dovish
정황/NNG,22,40,62,0.4985094500089959,Dovish
휘청이/VV,7,19,26,0.3339297751256432,Dovish
물가/NNG;인상/NNG,8,13,21,0.5577728111988766,Dovish
비준/NNG,19,28,47,0.6150441266344755,Dovish
이전/NNG;완화/NNG,6,13,19,0.4183296083991574,Dovish
저리/NNG,36,45,81,0.7251046545585396,Dovish
판매/NNG;호조/NNG,13,24,37,0.49095627652401114,Dovish
도박/NNG,10,12,22,0.7553173484984788,Dovish
육상/NNG,42,55,97,0.692145352078606,Dovish
순풍/NNG,10,25,35,0.3625523272792698,Dovish
랜드마크/NNG,16,27,43,0.5371145589322516,Dovish
비례/NNG,64,88,152,0.6591860495986723,Dovish
미/NNG;국채/NNG;상승/NNG,12,16,28,0.6797856136486308,Dovish
근로/NNG,67,82,149,0.7405794490155816,Dovish
격렬/NNG,11,14,25,0.7121563571557085,Dovish
기대/NNG;인플레이션/NNG;둔화/NNG,12,17,29,0.639798224610476,Dovish
민간/NNG;고용/NNG;증가/NNG,32,40,72,0.7251046545585396,Dovish
고율/NNG,6,12,18,0.4531904090990872,Dovish
찬성표/NNG,12,20,32,0.5438284909189046,Dovish
안공/NNG,10,15,25,0.604253878798783,Dovish
의회예산국/NNG,14,21,35,0.6042538787987829,Dovish
사업지/NNG,6,13,19,0.4183296083991574,Dovish
폴폴/MAG,42,56,98,0.6797856136486309,Dovish
자연/NNG,200,245,445,0.7399027087332036,Dovish
결정권/NNG,4,15,19,0.2417015515195132,Dovish
g8/NNG,12,16,28,0.6797856136486308,Dovish
분자/NNG,12,19,31,0.5724510430725313,Dovish
온전/NNG,11,17,28,0.5864817058929364,Dovish
인텔리/NNG,7,16,23,0.3965416079617013,Dovish
사공/NNG,7,42,49,0.15106346969969572,Dovish
전영역/NNG,11,23,34,0.4334864782686921,Dovish
야후/NNG,11,25,36,0.3988075600071967,Dovish
미달액/NNG,34,49,83,0.6289173024232231,Dovish
비거치식/NNG,3,31,34,0.08771427272885558,Dovish
예상/NNG;증가/NNG;밑돌/VV,4,40,44,0.09063808181981745,Dovish
현선물/NNG,42,53,95,0.718264044609874,Dovish
홍보/NNG,52,79,131,0.5966050955228489,Dovish
르포/NNG,49,66,115,0.6729190922986447,Dovish
개막/NNG,19,57,76,0.30212693939939145,Dovish
상방/NNG;압력/NNG;높/VA,11,14,25,0.7121563571557085,Dovish
갖춰야/VV,6,11,17,0.49438953719900425,Dovish
조업일수/NNG,42,57,99,0.6678595502512864,Dovish
앞세워/VV,31,37,68,0.7594001449768488,Dovish
콜시장/NNG,2,23,25,0.07881572332158039,Dovish
선뜻/MAG,14,17,31,0.7464312620455553,Dovish
국제/NNG;금융시장/NNG;변동성/NNG;확대/NNG,10,15,25,0.604253878798783,Dovish
출마/NNG,31,39,70,0.7204565477985488,Dovish
포린트/NNG,115,139,254,0.7498834107394969,Dovish
등유/NNG,7,17,24,0.37321563102277766,Dovish
무이자/NNG,17,28,45,0.5503026396203202,Dovish
통장/NNG,38,80,118,0.43053088864413286,Dovish
편입비중/NNG,89,109,198,0.7400724111893351,Dovish
하락/NNG;최저/NNG,10,30,40,0.3021269393993915,Dovish
디스크/NNG,6,15,21,0.3625523272792698,Dovish
종금/MAG,44,102,146,0.39098780392862426,Dovish
불똥/NNG,12,15,27,0.7251046545585396,Dovish
가수요/NNG,25,46,71,0.49259827075987744,Dovish
브로커리지/NNG,21,32,53,0.594812411942552,Dovish
공적연금/NNG,17,31,48,0.49704754546351493,Dovish
뉴비/NNG,20,27,47,0.6713931986653144,Dovish
보호주의/NNG,7,26,33,0.24402560489950847,Dovish
박수/NNG,16,26,42,0.5577728111988766,Dovish
우려/NNG;축소/NNG,8,10,18,0.7251046545585396,Dovish
부정/NNG,86,108,194,0.721747688565213,Dovish
기업구조조정촉진법/NNG,7,18,25,0.3524814292992901,Dovish
금융중개지원대출/NNG,37,71,108,0.47233929962440074,Dovish
수증/NNG,24,34,58,0.639798224610476,Dovish
자문사/NNG,4,17,21,0.2132660748701587,Dovish
득득/MAG,19,29,48,0.5938357084746659,Dovish
소비자/NNG;심리/NNG;개선/NNG,7,11,18,0.5767877933988383,Dovish
사회적비용/NNG,7,11,18,0.5767877933988383,Dovish
물가/NNG;강하/VA,6,11,17,0.49438953719900425,Dovish
공적/NNG,12,15,27,0.7251046545585396,Dovish
국채/NNG;발행/NNG;부담/NNG,23,33,56,0.6317199641987277,Dovish
퍼질/VV,8,10,18,0.7251046545585396,Dovish
당과/NNG,9,11,20,0.7415843057985064,Dovish
신청일/NNG,8,13,21,0.5577728111988766,Dovish
공모펀드/NNG,19,29,48,0.5938357084746659,Dovish
비축유/NNG,10,20,30,0.45319040909908725,Dovish
스냅샷/NNG,16,28,44,0.5179318961132426,Dovish
두르/VV,12,16,28,0.6797856136486308,Dovish
레포/NNG,210,316,526,0.6023416829797995,Dovish
이자/NNG;부담/NNG;경감/NNG,11,16,27,0.6231368125112449,Dovish
대의원/NNG,6,14,20,0.3884489220849319,Dovish
지출/NNG;늘/VV,16,26,42,0.5577728111988766,Dovish
국무회의/NNG,34,57,91,0.5406482073462794,Dovish
時差/NNG,1,26,27,0.034860800699929785,Dovish
전망/NNG;fed/NNG;금리/NNG;인하/NNG,7,11,18,0.5767877933988383,Dovish
재수주/NNG,15,32,47,0.42486600853039425,Dovish
중앙은행장/NNG,4,21,25,0.17264396537108084,Dovish
수출/NNG;부정적/VAX,9,12,21,0.6797856136486309,Dovish
국고채/NNG;금리/NNG;상승/NNG;금리/NNG;상승/NNG,6,19,25,0.2862255215362656,Dovish
연방/NNG,438,562,1000,0.7063964383822071,Dovish
물가/NNG;전망/NNG;높/VV,6,12,18,0.4531904090990872,Dovish
롤러코스터/NNG,18,26,44,0.6274944125987362,Dovish
골라/VV,7,12,19,0.5287221439489351,Dovish
배당가능이익/NNG,7,26,33,0.24402560489950847,Dovish
금리/NNG;상승/NNG;변동성/NNG;확대/NNG,6,11,17,0.49438953719900425,Dovish
fed/NNG;물가/NNG;상승/NNG,8,11,19,0.6591860495986723,Dovish
이자비용/NNG;늘/VV,6,12,18,0.4531904090990872,Dovish
양적완화/NNG;축소/NNG,8,22,30,0.32959302479933617,Dovish
변동성/NNG;작/VA,7,17,24,0.37321563102277766,Dovish
전환기/NNG,6,96,102,0.0566488011373859,Dovish
침묵/NNG,20,27,47,0.6713931986653144,Dovish
합의문/NNG,11,14,25,0.7121563571557085,Dovish
임차인/NNG,37,59,96,0.5684083097174992,Dovish
속한다/VV,11,19,30,0.5247467894831536,Dovish
국채입찰/NNG;수요/NNG;부진/NNG,2,19,21,0.09540850717875521,Dovish
발령/NNG,11,19,30,0.5247467894831536,Dovish
교도/NNG,41,79,120,0.47040017146993857,Dovish
달러엔/NNG;하락/NNG,9,13,22,0.6274944125987362,Dovish
일례/NNG,30,37,67,0.7349033661066279,Dovish
보인다며/VV,8,12,20,0.604253878798783,Dovish
외부충격/NNG,30,37,67,0.7349033661066279,Dovish
국유화/NNG,9,16,25,0.5098392102364732,Dovish
생선/NNG,6,15,21,0.3625523272792698,Dovish
베스/NNG,9,23,32,0.35467075494711175,Dovish
배당률/NNG,6,20,26,0.2719142454594523,Dovish
연수/NNG,19,34,53,0.5065069278166269,Dovish
per/NNG,178,227,405,0.7107303332126654,Dovish
의료비/NNG,22,32,54,0.6231368125112449,Dovish
건전성/NNG;저하/NNG,8,14,22,0.5179318961132426,Dovish
설건/NNG,29,66,95,0.39825823829919793,Dovish
실적/NNG;안정/NNG,6,11,17,0.49438953719900425,Dovish
연설문/NNG,18,34,52,0.47984866845785706,Dovish
광업/NNG,87,108,195,0.7301401035485294,Dovish
부추긴/VV,10,12,22,0.7553173484984788,Dovish
기기국/NNG,5,14,19,0.32370743507077665,Dovish
금리/NNG;상승/NNG;국채/NNG;금리/NNG;오르/VV,8,10,18,0.7251046545585396,Dovish
평평/NNG,443,644,1087,0.6234886684189306,Dovish
주택시장/NNG;안정/NNG,9,11,20,0.7415843057985064,Dovish
드디어/MAG,31,39,70,0.7204565477985488,Dovish
마테오/NNG,5,12,17,0.3776586742492394,Dovish
도드프랭크법/NNG,6,12,18,0.4531904090990872,Dovish
막론/NNG,18,26,44,0.6274944125987362,Dovish
달러원/NNG;하방/NNG,9,14,23,0.5826733831273979,Dovish
조지/NNG,9,15,24,0.5438284909189047,Dovish
달러원/NNG;상승/NNG;압력/NNG,10,21,31,0.4316099134277021,Dovish
집행위원회/NNG,25,47,72,0.48211745648839066,Dovish
최대/NNG;적자/NNG,7,10,17,0.6344665727387221,Dovish
안도/NNG,141,179,320,0.7139647785806849,Dovish
필요시/NNG,119,143,262,0.7542609605984808,Dovish
아폴로/NNG,5,18,23,0.25177244949949296,Dovish
가계조사/NNG,18,34,52,0.47984866845785706,Dovish
크레딧/NNG;선호/NNG,6,14,20,0.3884489220849319,Dovish
링깃/NNG,54,76,130,0.6440074234565977,Dovish
opec/NNG,381,519,900,0.6653778260761166,Dovish
리먼브라더스사태/NNG,37,51,88,0.6575703975163226,Dovish
이미/MAG;금리/NNG;인하/NNG,23,31,54,0.6724760909212262,Dovish
지배/NNG,82,107,189,0.6946095989929935,Dovish
환율조작국/NNG,25,51,76,0.44430432264616393,Dovish
직선/NNG,2,15,17,0.1208507757597566,Dovish
투영/NNG,5,17,22,0.26658259358769837,Dovish
환원/NNG,126,154,280,0.7415843057985064,Dovish
캠페인/NNG,30,57,87,0.47704253589377593,Dovish
선언/NNG,270,357,627,0.6854980977969386,Dovish
신민/NNG,1,24,25,0.03776586742492394,Dovish
마르/VV,8,10,18,0.7251046545585396,Dovish
제자리/NNG,43,72,115,0.5413107664239097,Dovish
인사이더/NNG,95,125,220,0.6888494218306125,Dovish
기보/NNG,22,34,56,0.5864817058929364,Dovish
기다려/VV,7,15,22,0.42297771515914806,Dovish
안일/NNG,13,30,43,0.3927650212192089,Dovish
수요예측/NNG;성공/NNG,12,28,40,0.3884489220849319,Dovish
국채/NNG;가격/NNG;혼조/NNG,20,26,46,0.6972160139985957,Dovish
의장직/NNG,6,11,17,0.49438953719900425,Dovish
저하/NNG;우려/NNG,9,11,20,0.7415843057985064,Dovish
알려져/VV,71,87,158,0.7396900930123033,Dovish
우주/NNG,51,80,131,0.5778177716013362,Dovish
객관적으로/MAG,6,14,20,0.3884489220849319,Dovish
항로/NNG,8,10,18,0.7251046545585396,Dovish
취지/NNG,105,164,269,0.5803047921390752,Dovish
사당/NNG,11,15,26,0.6646792666786613,Dovish
양자/NNG,58,73,131,0.7201381843218372,Dovish
상하위/NNG,57,82,139,0.630045202893853,Dovish
사면/NNG,11,17,28,0.5864817058929364,Dovish
타게팅/NNG,26,50,76,0.4713180254630507,Dovish
디플레이션/NNG;우려/NNG,15,27,42,0.5035448989989858,Dovish
투자심리/NNG;호조/NNG,8,10,18,0.7251046545585396,Dovish
승리/NNG,163,196,359,0.7537758845219512,Dovish
일본식/NNG,8,30,38,0.2417015515195132,Dovish
wto/NNG,20,54,74,0.3356965993326572,Dovish
등록/NNG,138,175,313,0.7147460166362748,Dovish
박탈/NNG,9,14,23,0.5826733831273979,Dovish
대가/NNG,51,61,112,0.7577937988214245,Dovish
소유자/NNG,21,56,77,0.33989280682431544,Dovish
가해/VV,17,22,39,0.7003851776985893,Dovish
월급/NNG,20,25,45,0.7251046545585396,Dovish
일식/NNG,5,13,18,0.34860800699929784,Dovish
장위/NNG,12,21,33,0.5179318961132425,Dovish
사옥/NNG,66,93,159,0.6432380000116077,Dovish
국제에너지기구/NNG,19,36,55,0.47836765404903653,Dovish
만날/VV,11,14,25,0.7121563571557085,Dovish
개척/NNG,14,27,41,0.4699752390657201,Dovish
빌딩/NNG,840,1756,2596,0.43357624560732727,Dovish
민평/NNG;낮/VA,15,20,35,0.6797856136486308,Dovish
개선/NNG;쉽/VA;않/VX,9,14,23,0.5826733831273979,Dovish
전망/NNG;불투명/NNG,9,13,22,0.6274944125987362,Dovish
극우파/NNG,6,18,24,0.3021269393993915,Dovish
재고조정/NNG,25,31,56,0.7309522727404633,Dovish
이론가/NNG,16,26,42,0.5577728111988766,Dovish
망설이/VV,14,21,35,0.6042538787987829,Dovish
작금/NNG,10,15,25,0.604253878798783,Dovish
국채선물/NNG;하락/NNG,14,32,46,0.3965416079617013,Dovish
세일즈/NNG,27,112,139,0.21850251867277423,Dovish
그랬/VV,40,67,107,0.5411228765362236,Dovish
세계/NNG;경기/NNG;회복/NNG,8,22,30,0.32959302479933617,Dovish
파트타임/NNG,20,24,44,0.7553173484984788,Dovish
소관/NNG,16,21,37,0.6905758614843234,Dovish
gdp/NNG;성장률/NNG;둔화/NNG,15,21,36,0.6474148701415531,Dovish
국채/NNG;금리/NNG;하방/NNG,10,17,27,0.5331651871753967,Dovish
순식간/NNG,17,21,38,0.7337368528270936,Dovish
정적/NNG,86,140,226,0.5567767883217357,Dovish
채권/NNG;매수/NNG;확대/NNG,9,12,21,0.6797856136486309,Dovish
스파/NNG,16,25,41,0.5800837236468316,Dovish
풍선/NNG,6,11,17,0.49438953719900425,Dovish
수집/NNG,32,41,73,0.707419175179063,Dovish
키프/NNG,3,24,27,0.1132976022747718,Dovish
신용등급/NNG;위험/NNG,7,20,27,0.31723328636936104,Dovish
평기/NNG,9,17,26,0.47984866845785706,Dovish
자본이익/NNG,32,69,101,0.42035052438176207,Dovish
납부/NNG,89,108,197,0.7469249335151623,Dovish
계부/NNG,23,33,56,0.6317199641987277,Dovish
지준율/NNG;인하/NNG,32,40,72,0.7251046545585396,Dovish
상상품/NNG,7,10,17,0.6344665727387221,Dovish
금석/NNG,1,49,50,0.018497567718330093,Dovish
북북/MAG,70,101,171,0.6281847254838833,Dovish
회사채/NNG;스프레드/NNG;확대/NNG,23,38,61,0.5485989162778424,Dovish
연산/NNG,10,20,30,0.45319040909908725,Dovish
부채/NNG;증가/NNG,55,71,126,0.7021259859281633,Dovish
중위값/NNG,17,25,42,0.6163389563747586,Dovish
중복/NNG,26,41,67,0.5747780798329887,Dovish
인권/NNG,24,39,63,0.5577728111988766,Dovish
국가재정운용계획/NNG,3,14,17,0.19422446104246596,Dovish
대체투자/NNG,136,297,433,0.4150430682658307,Dovish
사계/NNG,1,49,50,0.018497567718330093,Dovish
길동/NNG,13,31,44,0.3800951818250409,Dovish
반란/NNG,18,23,41,0.7093415098942235,Dovish
초년/NNG,2,21,23,0.08632198268554042,Dovish
연체율/NNG;상승/NNG,47,57,104,0.7473666395669157,Dovish
수출/NNG;경기/NNG;회복/NNG,11,16,27,0.6231368125112449,Dovish
최저임금/NNG,161,266,427,0.5485989162778425,Dovish
상환기금채/NNG,16,39,55,0.37184854079925106,Dovish
석사/NNG,6,12,18,0.4531904090990872,Dovish
탈채/NNG,154,188,342,0.7424608829921217,Dovish
fed/NNG;금리/NNG;인하/NNG;줄/VV,6,13,19,0.4183296083991574,Dovish
특단/NNG,10,18,28,0.5035448989989859,Dovish
생산/NNG;회복/NNG,8,11,19,0.6591860495986723,Dovish
전망/NNG;인하/NNG,34,41,75,0.7516328736277544,Dovish
다뤄/VV,8,14,22,0.5179318961132426,Dovish
살인/NNG,6,15,21,0.3625523272792698,Dovish
마이너스gdp/NNG,43,54,97,0.721747688565213,Dovish
법무부/NNG,31,66,97,0.42572432369914254,Dovish
디플레이션/NNG,330,555,885,0.5389291351448604,Dovish
질아/NNG,5,12,17,0.3776586742492394,Dovish
열기/NNG,102,122,224,0.7577937988214245,Dovish
가상화폐/NNG,92,145,237,0.5750830018912555,Dovish
온다/VV,41,55,96,0.6756657008386391,Dovish
철저히/MAG,32,44,76,0.6591860495986723,Dovish
자자/VV,72,170,242,0.38387893476628565,Dovish
훌륭/NNG,12,28,40,0.3884489220849319,Dovish
주택/NNG;경기/NNG;회복/NNG,11,18,29,0.5538993888988843,Dovish
한국판/NNG,53,67,120,0.7169878114104963,Dovish
適應/NNG,1,26,27,0.034860800699929785,Dovish
가나/NNG,7,24,31,0.26436107197446757,Dovish
성장전략/NNG,21,28,49,0.6797856136486309,Dovish
산출물/NNG,9,16,25,0.5098392102364732,Dovish
손절/NNG,97,117,214,0.7514439261984865,Dovish
정부보증채/NNG,38,79,117,0.4359806467282358,Dovish
영원/NNG,7,14,21,0.45319040909908725,Dovish
봉천/NNG,7,16,23,0.3965416079617013,Dovish
전문인력/NNG,10,13,23,0.6972160139985957,Dovish
밝혔으며/VV,15,35,50,0.38844892208493187,Dovish
부스/NNG,8,12,20,0.604253878798783,Dovish
은행지주회사/NNG,19,31,50,0.555523727282752,Dovish
물가/NNG;상승/NNG;견인/NNG,10,12,22,0.7553173484984788,Dovish
금융시장/NNG;금리/NNG;인하/NNG,12,26,38,0.4183296083991574,Dovish
배당투자/NNG,5,17,22,0.26658259358769837,Dovish
결선/NNG,14,32,46,0.3965416079617013,Dovish
금리/NNG;하향/NNG,48,60,108,0.7251046545585396,Dovish
물리/NNG,31,54,85,0.5203297289656187,Dovish
금리/NNG;상승/NNG;압력/NNG;높/VV,7,12,19,0.5287221439489351,Dovish
우려/NNG;경계/NNG,9,11,20,0.7415843057985064,Dovish
국고채/NNG;오르/VV,15,23,38,0.5911179249118529,Dovish
폭우/NNG,10,30,40,0.3021269393993915,Dovish
처할/VV,19,24,43,0.7175514810735547,Dovish
호조/NNG;금리/NNG;인하/NNG,6,12,18,0.4531904090990872,Dovish
치킨게임/NNG,7,19,26,0.3339297751256432,Dovish
비합리/NNG,11,15,26,0.6646792666786613,Dovish
양재/NNG,7,11,18,0.5767877933988383,Dovish
관망/NNG,147,240,387,0.5551582511463818,Dovish
위법/NNG,6,14,20,0.3884489220849319,Dovish
잔잔/NNG,77,133,210,0.5247467894831537,Dovish
상품권/NNG,9,20,29,0.4078713681891785,Dovish
채권비율/NNG,15,22,37,0.6179869214987552,Dovish
하락/NNG;방어/NNG,6,13,19,0.4183296083991574,Dovish
세우/VV,34,41,75,0.7516328736277544,Dovish
사드/NNG,30,55,85,0.4943895371990042,Dovish
눌리/VV,16,21,37,0.6905758614843234,Dovish
인플레이션/NNG;전망/NNG;하향/NNG,4,17,21,0.2132660748701587,Dovish
부차/NNG,5,13,18,0.34860800699929784,Dovish
공표/NNG,130,169,299,0.6972160139985957,Dovish
배치/NNG,55,143,198,0.3486080069992979,Dovish
포자/NNG,7,12,19,0.5287221439489351,Dovish
질병/NNG,18,29,47,0.5625811975023152,Dovish
금과/NNG,30,36,66,0.7553173484984786,Dovish
금리선물/NNG;시장/NNG;fed/NNG;금리/NNG;인하/NNG,8,29,37,0.25003608777880676,Dovish
합계/NNG,841,1030,1871,0.7400643379656939,Dovish
가자지구/NNG,77,108,185,0.6462159537153652,Dovish
영수/NNG,20,58,78,0.3125451097235084,Dovish
철수/NNG,48,113,161,0.3850113210045342,Dovish
편집자/NNG,13,20,33,0.5891475318288134,Dovish
고품질/NNG,9,11,20,0.7415843057985064,Dovish
기대/NNG;후퇴/NNG,22,32,54,0.6231368125112449,Dovish
달러원/NNG;상단/NNG;제한/NNG,8,18,26,0.40283591919918865,Dovish
이안/NNG,6,17,23,0.319899112305238,Dovish
투자포인트/NNG,16,21,37,0.6905758614843234,Dovish
기업명/NNG,331,412,743,0.7281845893776596,Dovish
무드/NNG,8,10,18,0.7251046545585396,Dovish
공천/NNG,7,50,57,0.1268933145477444,Dovish
탈탈/MAG,18,28,46,0.5826733831273979,Dovish
부담액/NNG,11,18,29,0.5538993888988843,Dovish
하방/NNG;위험/NNG;확대/NNG,7,13,20,0.48805120979901695,Dovish
휩쓸/VV,7,11,18,0.5767877933988383,Dovish
국채/NNG;발행/NNG;증가/NNG;우려/NNG,8,11,19,0.6591860495986723,Dovish
식식/MAG,85,116,201,0.6641583581624554,Dovish
경제/NNG;성장/NNG;견조/NNG,5,18,23,0.25177244949949296,Dovish
유동성/NNG;증가/NNG,16,21,37,0.6905758614843234,Dovish
임금/NNG;인상/NNG,62,145,207,0.3875559360571504,Dovish
표방/NNG,5,22,27,0.20599564049958513,Dovish
지상전/NNG,7,22,29,0.28839389669941917,Dovish
경쟁업체/NNG,10,14,24,0.6474148701415533,Dovish
만일/NNG,138,185,323,0.6761110968180978,Dovish
자산/NNG;매입/NNG;확대/NNG,6,12,18,0.4531904090990872,Dovish
매크로팀/NNG,6,11,17,0.49438953719900425,Dovish
통화신용정책/NNG,21,46,67,0.413782547438297,Dovish
없애/VV,41,60,101,0.6193602257687525,Dovish
특수/NNG,576,746,1322,0.6998329105658827,Dovish
원자재/NNG;가격/NNG;안정/NNG,8,11,19,0.6591860495986723,Dovish
기전/NNG,8,10,18,0.7251046545585396,Dovish
가득/MAG,14,27,41,0.4699752390657201,Dovish
전월세/NNG,30,104,134,0.2614560052494734,Dovish
금융지원/NNG;확대/NNG,8,11,19,0.6591860495986723,Dovish
순이자마진/NNG;개선/NNG,7,11,18,0.5767877933988383,Dovish
골고루/MAG,10,15,25,0.604253878798783,Dovish
옮겨갈/VV,20,27,47,0.6713931986653144,Dovish
치닫/VV,22,29,51,0.6875992413917185,Dovish
적발/NNG,8,24,32,0.3021269393993915,Dovish
예언/NNG,7,19,26,0.3339297751256432,Dovish
돌풍/NNG,5,18,23,0.25177244949949296,Dovish
이윤/NNG,9,30,39,0.27191424545945236,Dovish
일단락/NNG,99,133,232,0.6746744436211976,Dovish
송환/NNG,24,34,58,0.639798224610476,Dovish
기수/NNG,8,21,29,0.3452879307421617,Dovish
높/VA;fed/NNG;금리/NNG;인상/NNG,13,19,32,0.6201552966619088,Dovish
국채/NNG;선호/NNG,10,14,24,0.6474148701415533,Dovish
시중/NNG;금리/NNG;하락/NNG,11,14,25,0.7121563571557085,Dovish
수탁자/NNG,21,27,48,0.7049628585985801,Dovish
적시/NNG,44,53,97,0.7524670943532014,Dovish
채권/NNG;금리/NNG;하락/NNG,80,102,182,0.7108869162338624,Dovish
입금/NNG,23,40,63,0.5211689704639503,Dovish
혹시나/MAG,7,20,27,0.31723328636936104,Dovish
퇴퇴/MAG,5,12,17,0.3776586742492394,Dovish
단기/NNG;금리/NNG;오르/VV,10,18,28,0.5035448989989859,Dovish
우선주/NNG,65,79,144,0.7457563694035612,Dovish
유료/NNG,9,16,25,0.5098392102364732,Dovish
테마/NNG,118,146,264,0.732554359913593,Dovish
개혁회의/NNG,2,21,23,0.08632198268554042,Dovish
인하/NNG;효과/NNG,31,62,93,0.45319040909908714,Dovish
번갈/VV,8,14,22,0.5179318961132426,Dovish
대조표/NNG,29,36,65,0.7301401035485295,Dovish
갑론을박/NNG,8,14,22,0.5179318961132426,Dovish
회원사/NNG,14,32,46,0.3965416079617013,Dovish
세제개편/NNG,30,46,76,0.5911179249118529,Dovish
서부텍사스산원유/NNG;가격/NNG;하락/NNG,5,37,42,0.12248389435110466,Dovish
장밋빛/NNG,17,24,41,0.6420197462237068,Dovish
단칸/NNG,15,19,34,0.715563803840664,Dovish
초저금리/NNG,125,171,296,0.6625590776302445,Dovish
새롭/VA;매파/NNG,7,15,22,0.42297771515914806,Dovish
생계비/NNG,8,22,30,0.32959302479933617,Dovish
저점/NNG;낮/VV,17,32,49,0.48151480966778015,Dovish
재분류/NNG,12,16,28,0.6797856136486308,Dovish
가슴/NNG,9,15,24,0.5438284909189047,Dovish
외채/NNG;증가/NNG,6,11,17,0.49438953719900425,Dovish
이익조정비율/NNG,4,13,17,0.2788864055994383,Dovish
예기/NNG,31,38,69,0.7394159306353528,Dovish
공동체/NNG,13,17,30,0.6931147433280157,Dovish
비농업/NNG;고용/NNG;늘/VV,9,12,21,0.6797856136486309,Dovish
월드/NNG,103,128,231,0.7293533146438435,Dovish
경품/NNG,8,22,30,0.32959302479933617,Dovish
재무관리계획/NNG,6,12,18,0.4531904090990872,Dovish
휴면/NNG,7,12,19,0.5287221439489351,Dovish
유통물/NNG,25,32,57,0.7081100142173238,Dovish
켄터키/NNG,8,13,21,0.5577728111988766,Dovish
민족/NNG,7,15,22,0.42297771515914806,Dovish
fed/NNG;인플레이션/NNG;억제/NNG,7,11,18,0.5767877933988383,Dovish
경제/NNG;살/VV,9,21,30,0.3884489220849319,Dovish
반길/VV,7,12,19,0.5287221439489351,Dovish
환자금/NNG,25,57,82,0.39753544657814666,Dovish
투자/NNG;우호적/VAX,7,11,18,0.5767877933988383,Dovish
원월물/NNG,5,21,26,0.21580495671385105,Dovish
투자/NNG;증가/NNG,29,37,66,0.710406587236407,Dovish
이뤄지며/VV,9,13,22,0.6274944125987362,Dovish
글로벌/NNG;경기/NNG;불확실성/NNG,12,20,32,0.5438284909189046,Dovish
한국인/NNG,13,23,36,0.5123022015902725,Dovish
전망/NNG;끝/NNG,8,10,18,0.7251046545585396,Dovish
모기지/NNG;금리/NNG;하락/NNG,10,16,26,0.5664880113738591,Dovish
경제/NNG;과열/NNG,11,24,35,0.41542454167416326,Dovish
나이/NNG,27,62,89,0.39471422727985017,Dovish
파산보호신청/NNG,12,31,43,0.35085709091542233,Dovish
피난처/NNG,8,10,18,0.7251046545585396,Dovish
채권시장/NNG;혼조/NNG,31,38,69,0.7394159306353528,Dovish
농축수산물/NNG;가격/NNG;상승/NNG,6,15,21,0.3625523272792698,Dovish
본고/NNG,9,13,22,0.6274944125987362,Dovish
잔존만기/NNG,745,1130,1875,0.5975696544757876,Dovish
청색/NNG,19,28,47,0.6150441266344755,Dovish
기술기업/NNG,61,88,149,0.6282867035237346,Dovish
우르/NNG,34,41,75,0.7516328736277544,Dovish
지나가/VV,36,68,104,0.47984866845785706,Dovish
신용위험/NNG;높/VA,7,12,19,0.5287221439489351,Dovish
과도기/NNG,16,38,54,0.38163402871502083,Dovish
봐도/VV,37,46,83,0.7290454407246185,Dovish
연루/NNG,8,10,18,0.7251046545585396,Dovish
전망/NNG;약세/NNG,8,13,21,0.5577728111988766,Dovish
바라본/VV,21,26,47,0.7320768146985255,Dovish
피피피/NNG,38,92,130,0.3743746857775068,Dovish
장단점/NNG,9,14,23,0.5826733831273979,Dovish
발췌/NNG,16,35,51,0.41434551689059407,Dovish
국고채/NNG;금리/NNG;소폭/MAG;하락/NNG,8,19,27,0.38163402871502083,Dovish
금리/NNG;인상/NNG;우려/NNG,36,46,82,0.7093415098942235,Dovish
모셔/VV,2,21,23,0.08632198268554042,Dovish
영하/NNG,7,23,30,0.2758550316255314,Dovish
수요/NNG;축소/NNG,8,18,26,0.40283591919918865,Dovish
묶이/VV,7,16,23,0.3965416079617013,Dovish
엔원/NNG,77,92,169,0.7586013369702113,Dovish
판가름/NNG,12,18,30,0.604253878798783,Dovish
신용/NNG;회복/NNG,11,15,26,0.6646792666786613,Dovish
부실징후기업/NNG,8,11,19,0.6591860495986723,Dovish
중공업/NNG,98,138,236,0.6436617404595731,Dovish
입출금/NNG,19,27,46,0.6378235387320487,Dovish
오바마케어/NNG,24,37,61,0.5879226928853023,Dovish
중추/NNG,7,13,20,0.48805120979901695,Dovish
다면/NNG,75,96,171,0.7081100142173238,Dovish
핵심국/NNG,4,16,20,0.2265952045495436,Dovish
제미/NNG,3,31,34,0.08771427272885558,Dovish
fed/NNG;금리/NNG;안정/NNG,6,11,17,0.49438953719900425,Dovish
금융중개기능/NNG,12,38,50,0.2862255215362656,Dovish
신흥국/NNG;성장/NNG,8,10,18,0.7251046545585396,Dovish
인플레이션/NNG;압력/NNG;높/VA,17,24,41,0.6420197462237068,Dovish
은행법/NNG,17,34,51,0.45319040909908714,Dovish
이점/NNG,31,50,81,0.5619561072828682,Dovish
과점/NNG,15,20,35,0.6797856136486308,Dovish
영업점/NNG,30,60,90,0.4531904090990872,Dovish
예상/NNG;증가/NNG;웃돌/VV,6,25,31,0.21753139636756186,Dovish
사스/NNG,25,46,71,0.49259827075987744,Dovish
경제/NNG;침체/NNG,24,33,57,0.6591860495986723,Dovish
들려/VV,3,14,17,0.19422446104246596,Dovish
엇갈린다/VV,8,13,21,0.5577728111988766,Dovish
입국자수/NNG,7,19,26,0.3339297751256432,Dovish
양적완화/NNG;확대/NNG,6,19,25,0.2862255215362656,Dovish
분담금/NNG,11,33,44,0.30212693939939145,Dovish
볼커룰/NNG,23,37,60,0.5634259140150814,Dovish
뱅킹/NNG,17,29,46,0.5313266865299643,Dovish
중도/NNG,135,199,334,0.6148814595816761,Dovish
실업률/NNG;떨어/VV,5,12,17,0.3776586742492394,Dovish
살포/NNG,3,20,23,0.13595712272972615,Dovish
좌표/NNG,9,17,26,0.47984866845785706,Dovish
메자닌/NNG,19,43,62,0.40049384990151893,Dovish
회사채/NNG;위험/NNG,9,16,25,0.5098392102364732,Dovish
다방면/NNG,14,48,62,0.26436107197446757,Dovish
드물/VA,30,37,67,0.7349033661066279,Dovish
견해차/NNG,10,13,23,0.6972160139985957,Dovish
전통시장/NNG,11,18,29,0.5538993888988843,Dovish
수요예측/NNG;실패/NNG,7,10,17,0.6344665727387221,Dovish
건설/NNG;투자/NNG;감소/NNG,8,10,18,0.7251046545585396,Dovish
컨퍼런스/NNG,112,203,315,0.5000721755576135,Dovish
지움/VV,12,16,28,0.6797856136486308,Dovish
반론/NNG,16,24,40,0.604253878798783,Dovish
클러스터/NNG,17,22,39,0.7003851776985893,Dovish
리비/NNG,21,35,56,0.5438284909189046,Dovish
나눠서/VV,9,11,20,0.7415843057985064,Dovish
선결/NNG,19,24,43,0.7175514810735547,Dovish
사업부문/NNG,106,136,242,0.7064438730074006,Dovish
가까스로/MAG,18,23,41,0.7093415098942235,Dovish
국채/NNG;금리/NNG;급등/NNG,63,95,158,0.6010735952261578,Dovish
레피/NNG,7,11,18,0.5767877933988383,Dovish
치사율/NNG,27,34,61,0.7197730026867856,Dovish
총비/NNG,1,31,32,0.029238090909618528,Dovish
경기/NNG;침체/NNG;없/VA,11,14,25,0.7121563571557085,Dovish
파파/NNG,33,60,93,0.498509450008996,Dovish
저금리/NNG,661,963,1624,0.6221367817538871,Dovish
구제기금/NNG,7,14,21,0.45319040909908725,Dovish
시장가치/NNG,17,23,40,0.6699336482334333,Dovish
속출/NNG,23,28,51,0.7445271006627863,Dovish
순증액/NNG,16,32,48,0.4531904090990872,Dovish
캐시/NNG,22,27,49,0.7385325185318458,Dovish
가빴/VA,3,56,59,0.04855611526061649,Dovish
열정/NNG,10,13,23,0.6972160139985957,Dovish
철철/MAG,28,43,71,0.5902014630127648,Dovish
나눔/VV,15,26,41,0.5229120104989468,Dovish
이득/NNG,26,42,68,0.5610928874560127,Dovish
홍수/NNG,11,19,30,0.5247467894831536,Dovish
나온다면/VV,59,76,135,0.7036377404433196,Dovish
위험/NNG;높/VA,53,69,122,0.6962055560072934,Dovish
매기/VV,9,16,25,0.5098392102364732,Dovish
모라토리엄/NNG,15,20,35,0.6797856136486308,Dovish
국고채/NNG;금리/NNG;급락/NNG,17,27,44,0.5706842188655172,Dovish
소위/NNG,52,65,117,0.7251046545585396,Dovish
줄어든다는/VV,9,15,24,0.5438284909189047,Dovish
중소기업진흥공단/NNG,34,54,88,0.5706842188655172,Dovish
종이/NNG,37,55,92,0.6097470958787718,Dovish
견인력/NNG,12,16,28,0.6797856136486308,Dovish
내수기업/NNG,11,32,43,0.31156840625562243,Dovish
실물/NNG;경기/NNG;회복/NNG,20,27,47,0.6713931986653144,Dovish
크레딧/NNG;약세/NNG,40,48,88,0.7553173484984788,Dovish
봉차트/NNG,23,41,64,0.5084575321599516,Dovish
금리/NNG;연고점/NNG,9,12,21,0.6797856136486309,Dovish
상장폐지/NNG,16,23,39,0.6305257865726431,Dovish
탈바꿈/NNG,8,17,25,0.4265321497403174,Dovish
오염/NNG,11,14,25,0.7121563571557085,Dovish
기대/NNG;긍정적/VAX,8,14,22,0.5179318961132426,Dovish
아기/NNG,10,14,24,0.6474148701415533,Dovish
바뀔지/VV,11,14,25,0.7121563571557085,Dovish
기업/NNG;이익/NNG;증가/NNG,15,18,33,0.7553173484984786,Dovish
자인/NNG,8,14,22,0.5179318961132426,Dovish
前轍/NNG,7,23,30,0.2758550316255314,Dovish
본연/NNG,22,29,51,0.6875992413917185,Dovish
주식펀드/NNG,215,307,522,0.6347618107902524,Dovish
cds/NNG;하락/NNG,8,10,18,0.7251046545585396,Dovish
순이자마진/NNG;하락/NNG,9,13,22,0.6274944125987362,Dovish
이어가기/NNG,14,18,32,0.7049628585985802,Dovish
스톡/NNG,12,19,31,0.5724510430725313,Dovish
국빈/NNG,8,10,18,0.7251046545585396,Dovish
빌린/VV,14,27,41,0.4699752390657201,Dovish
스피릿/NNG,2,23,25,0.07881572332158039,Dovish
매장/NNG,82,99,181,0.7507396675984879,Dovish
국립/NNG,20,27,47,0.6713931986653144,Dovish
외국환은행/NNG,27,40,67,0.6118070522837677,Dovish
몸값/NNG,16,22,38,0.6591860495986723,Dovish
춘투/NNG,34,117,151,0.2633927163994695,Dovish
공급원/NNG,8,10,18,0.7251046545585396,Dovish
기상청/NNG,8,19,27,0.38163402871502083,Dovish
신용등급/NNG;전망/NNG;상향/NNG,10,12,22,0.7553173484984788,Dovish
저축률/NNG;하락/NNG,9,17,26,0.47984866845785706,Dovish
수출/NNG;늘/VV,18,22,40,0.7415843057985064,Dovish
에이스/NNG,34,138,172,0.22331121607781107,Dovish
금호/NNG,4,13,17,0.2788864055994383,Dovish
a-등급/NNG,41,73,114,0.5090631992619883,Dovish
포커스/NNG,32,42,74,0.6905758614843234,Dovish
낙관론/NNG,118,156,274,0.685595747098619,Dovish
운용자금/NNG,6,11,17,0.49438953719900425,Dovish
적자국/NNG,13,18,31,0.6546083686986816,Dovish
말라/VV,8,12,20,0.604253878798783,Dovish
금리/NNG;오르/VV;내리/VV,7,10,17,0.6344665727387221,Dovish
보좌관/NNG,20,29,49,0.6250902194470168,Dovish
불러일으키/VV,10,12,22,0.7553173484984788,Dovish
보성/NNG,14,18,32,0.7049628585985802,Dovish
cds/NNG;상승/NNG,13,16,29,0.7364344147860167,Dovish
파도/NNG,7,12,19,0.5287221439489351,Dovish
신종자본증권/NNG,381,523,904,0.6602888943279245,Dovish
용채/NNG,19,70,89,0.2460176506537902,Dovish
지정가/NNG,14,25,39,0.5075732581909776,Dovish
심리/NNG;회복/NNG,25,31,56,0.7309522727404633,Dovish
실물/NNG;경제/NNG;회복/NNG,11,16,27,0.6231368125112449,Dovish
노골/NNG,10,14,24,0.6474148701415533,Dovish
채권시장/NNG;모멘텀/NNG,10,15,25,0.604253878798783,Dovish
나뉘/VV,27,33,60,0.7415843057985064,Dovish
안전판/NNG,13,31,44,0.3800951818250409,Dovish
속한/VV,50,61,111,0.7429350968837496,Dovish
매수기회/NNG,113,152,265,0.6738225819499586,Dovish
현장검사/NNG,3,15,18,0.1812761636396349,Dovish
선수촌/NNG,7,17,24,0.37321563102277766,Dovish
에이디/NNG,8,10,18,0.7251046545585396,Dovish
경제/NNG;지표/NNG;강세/NNG,10,13,23,0.6972160139985957,Dovish
개발자/NNG,15,83,98,0.1638037623249713,Dovish
육아/NNG,35,64,99,0.49567700995212666,Dovish
전공의/NNG,27,59,86,0.41478444222628325,Dovish
구조적/VAX;저성장/NNG,11,16,27,0.6231368125112449,Dovish
닷컴/NNG,119,149,268,0.7238880360106225,Dovish
외국인/NNG;자금/NNG;이탈/NNG,21,34,55,0.5598234465341665,Dovish
강구/NNG,68,106,174,0.5814518456365647,Dovish
신흥국/NNG;통화/NNG;약세/NNG,19,31,50,0.555523727282752,Dovish
마이크로컴퓨터/NNG,22,71,93,0.2808503943712653,Dovish
높/VA;강세/NNG,9,12,21,0.6797856136486309,Dovish
db/NNG,837,1097,1934,0.6915594756899471,Dovish
유보/NNG,70,94,164,0.6749644390837469,Dovish
식별/NNG,15,20,35,0.6797856136486308,Dovish
감가상각비/NNG,9,16,25,0.5098392102364732,Dovish
유로그룹/NNG,9,11,20,0.7415843057985064,Dovish
레이스/NNG,10,27,37,0.3356965993326572,Dovish
강서/NNG,8,22,30,0.32959302479933617,Dovish
궁성/NNG,5,20,25,0.22659520454954363,Dovish
수전/NNG,11,54,65,0.18463312963296144,Dovish
적적/NNG,465,558,1023,0.7553173484984788,Dovish
주택건설협회/NNG,13,16,29,0.7364344147860167,Dovish
재테크/NNG,12,16,28,0.6797856136486308,Dovish
트래블/NNG,10,28,38,0.32370743507077665,Dovish
자유당/NNG,7,15,22,0.42297771515914806,Dovish
규율/NNG,16,28,44,0.5179318961132426,Dovish
산유국/NNG,129,195,324,0.5996057720387923,Dovish
금지법/NNG,6,13,19,0.4183296083991574,Dovish
투자계획/NNG,46,58,104,0.7188537523640693,Dovish
인수/NNG;부담/NNG,7,12,19,0.5287221439489351,Dovish
달러위안/NNG;환율/NNG;하락/NNG,6,12,18,0.4531904090990872,Dovish
경제정책/NNG;불확실성/NNG,9,11,20,0.7415843057985064,Dovish
상향/NNG;금리/NNG;인상/NNG,8,11,19,0.6591860495986723,Dovish
매치/NNG,11,14,25,0.7121563571557085,Dovish
小考/NNG,6,15,21,0.3625523272792698,Dovish
금리/NNG;인하/NNG;멀/VA,13,17,30,0.6931147433280157,Dovish
핑계/NNG,5,12,17,0.3776586742492394,Dovish
받아들여졌/VV,12,17,29,0.639798224610476,Dovish
증가량/NNG,9,16,25,0.5098392102364732,Dovish
국고채/NNG;내리/VV,16,22,38,0.6591860495986723,Dovish
기업형/NNG,3,15,18,0.1812761636396349,Dovish
패니매/NNG,4,20,24,0.1812761636396349,Dovish
국채/NNG;금리/NNG;넘/VV,15,28,43,0.4855611526061649,Dovish
안전통화/NNG,18,27,45,0.604253878798783,Dovish
찬반/NNG,9,21,30,0.3884489220849319,Dovish
메우/VV,44,53,97,0.7524670943532014,Dovish
먹거리/NNG,19,37,56,0.4654387985341977,Dovish
특고/NNG,8,13,21,0.5577728111988766,Dovish
대내외/NNG;경기/NNG;개선/NNG,8,22,30,0.32959302479933617,Dovish
상징/NNG,45,62,107,0.6578570454664169,Dovish
레지던스/NNG,11,21,32,0.4747709047704723,Dovish
비관/NNG,116,152,268,0.6917116770459752,Dovish
밀사/NNG,6,12,18,0.4531904090990872,Dovish
여정/NNG,30,49,79,0.5549270315499026,Dovish
행인/NNG,4,15,19,0.2417015515195132,Dovish
촉매제/NNG,29,41,70,0.6410986275060259,Dovish
띈다/VV,36,62,98,0.5262856363731335,Dovish
상법/NNG,12,28,40,0.3884489220849319,Dovish
수용/NNG,125,216,341,0.5245259364572769,Dovish
발행/NNG;증가/NNG;우려/NNG,9,13,22,0.6274944125987362,Dovish
공공사사/NNG,12,17,29,0.639798224610476,Dovish
마인드/NNG,7,24,31,0.26436107197446757,Dovish
현직/NNG,12,26,38,0.4183296083991574,Dovish
놓여/VV,46,65,111,0.6414387328787081,Dovish
워크아웃/NNG,149,281,430,0.4806076224609537,Dovish
처했/VV,10,16,26,0.5664880113738591,Dovish
과매수/NNG,34,51,85,0.6042538787987829,Dovish
신용등급/NNG;하향/NNG;압력/NNG,8,11,19,0.6591860495986723,Dovish
상생/NNG,130,198,328,0.5950985169988015,Dovish
대안/NNG,228,320,548,0.6457963329661993,Dovish
사상/NNG,955,1395,2350,0.62049726263746,Dovish
노벨경제학상/NNG,7,10,17,0.6344665727387221,Dovish
주택시장/NNG;부진/NNG,12,17,29,0.639798224610476,Dovish
경기/NNG;부양/NNG,148,198,346,0.6774967731986354,Dovish
하락/NNG;압력/NNG,78,111,189,0.6369162506257443,Dovish
교직원/NNG,12,24,36,0.4531904090990872,Dovish
글로벌/NNG;경기/NNG;침체/NNG;우려/NNG,14,17,31,0.7464312620455553,Dovish
위생/NNG,8,11,19,0.6591860495986723,Dovish
낙찰률/NNG,105,205,310,0.4642438337112601,Dovish
업황/NNG;호조/NNG,7,12,19,0.5287221439489351,Dovish
금리/NNG;변동성/NNG;크/VV,19,25,44,0.6888494218306125,Dovish
대림/NNG,36,75,111,0.43506279273512377,Dovish
만일/MAG,95,121,216,0.7116213035440213,Dovish
글로벌/NNG;성장/NNG,16,20,36,0.7251046545585396,Dovish
gdp/NNG;둔화/NNG,8,15,23,0.4834031030390264,Dovish
설치/NNG,110,147,257,0.6782441496721032,Dovish
당사자/NNG,33,42,75,0.7121563571557085,Dovish
브로드밴드/NNG,31,61,92,0.4606197600679247,Dovish
의아/NNG,9,18,27,0.45319040909908725,Dovish
해답/NNG,10,27,37,0.3356965993326572,Dovish
자문/NNG,57,81,138,0.6378235387320487,Dovish
부동산투자신탁/NNG,13,19,32,0.6201552966619088,Dovish
우려/NNG;감소/NNG,14,20,34,0.6344665727387221,Dovish
유죄/NNG,11,17,28,0.5864817058929364,Dovish
채권은행/NNG,20,79,99,0.22946349827801885,Dovish
다지/VV,59,84,143,0.6366246223058606,Dovish
영한/VA,13,27,40,0.43640557913245437,Dovish
발행주식/NNG,5,12,17,0.3776586742492394,Dovish
낮/VA;추세/NNG,9,20,29,0.4078713681891785,Dovish
블랙프라이데이/NNG,10,14,24,0.6474148701415533,Dovish
기술력/NNG,16,21,37,0.6905758614843234,Dovish
아무리/MAG,39,57,96,0.6201552966619088,Dovish
소외/NNG,81,132,213,0.5561882293488798,Dovish
안전피난처/NNG,12,17,29,0.639798224610476,Dovish
동요/NNG,9,12,21,0.6797856136486309,Dovish
인하/NNG;가능성/NNG;배제/NNG,9,18,27,0.45319040909908725,Dovish
금리/NNG;인하/NNG;서둘/VV;않/VX,56,98,154,0.5179318961132425,Dovish
기능/NNG,228,317,545,0.6519079701866997,Dovish
안기/VV,19,26,45,0.6623552132986659,Dovish
글로벌리/MAG,22,35,57,0.5697250857245667,Dovish
생애/NNG,31,39,70,0.7204565477985488,Dovish
이리/MAG,5,12,17,0.3776586742492394,Dovish
센터/NNG,258,635,893,0.36826181274823466,Dovish
공아/NNG,39,63,102,0.5610928874560127,Dovish
수요/NNG;흡수/NNG,9,13,22,0.6274944125987362,Dovish
부동산/NNG;과열/NNG,9,11,20,0.7415843057985064,Dovish
되게/MAG,53,81,134,0.5930639921543611,Dovish
산적/NNG,12,15,27,0.7251046545585396,Dovish
넘나들/VV,18,26,44,0.6274944125987362,Dovish
상환기간/NNG,7,16,23,0.3965416079617013,Dovish
글로벌/NNG;통화정책/NNG;완화/NNG,4,19,23,0.19081701435751042,Dovish
개인/NNG;소비/NNG;지출/NNG;증가/NNG,11,14,25,0.7121563571557085,Dovish
fed/NNG;ecb/NNG;금리/NNG;인하/NNG,9,15,24,0.5438284909189047,Dovish
소비/NNG;줄/VV,16,21,37,0.6905758614843234,Dovish
심장/NNG,3,14,17,0.19422446104246596,Dovish
예상/NNG;강세/NNG,12,15,27,0.7251046545585396,Dovish
접전/NNG,12,21,33,0.5179318961132425,Dovish
자금/NNG;조달/NNG;성공/NNG,7,18,25,0.3524814292992901,Dovish
남승/NNG,11,15,26,0.6646792666786613,Dovish
스튜디오/NNG,25,30,55,0.7553173484984788,Dovish
실망매물/NNG,4,21,25,0.17264396537108084,Dovish
이기/VV,22,29,51,0.6875992413917185,Dovish
국외/NNG,58,99,157,0.5310109843989306,Dovish
전망/NNG;우세/NNG,61,77,138,0.7180419468842681,Dovish
경제/NNG;우려/NNG,16,26,42,0.5577728111988766,Dovish
스로/NNG,8,18,26,0.40283591919918865,Dovish
알려진/VV,105,133,238,0.7155638038406641,Dovish
선임/NNG,148,202,350,0.6640809955115337,Dovish
목돈/NNG,16,26,42,0.5577728111988766,Dovish
개당/NNG,8,10,18,0.7251046545585396,Dovish
실물/NNG;경기/NNG;둔화/NNG,9,11,20,0.7415843057985064,Dovish
출범/NNG,157,195,352,0.7297527613185302,Dovish
과태료/NNG,5,13,18,0.34860800699929784,Dovish
금리/NNG;압박/NNG,4,13,17,0.2788864055994383,Dovish
시의/NNG,8,10,18,0.7251046545585396,Dovish
마친/VV,45,65,110,0.6274944125987362,Dovish
전병/NNG,264,352,616,0.6797856136486309,Dovish
소득공제/NNG,11,18,29,0.5538993888988843,Dovish
일독/NNG,66,100,166,0.5982113400107951,Dovish
보증보험/NNG,8,14,22,0.5179318961132426,Dovish
긍정적/VAX;안정/NNG,28,35,63,0.7251046545585396,Dovish
금융센터/NNG,27,50,77,0.4894456418270142,Dovish
칼럼니스트/NNG,12,20,32,0.5438284909189046,Dovish
보관/NNG,26,44,70,0.5355886652989212,Dovish
고용/NNG;지표/NNG;금리/NNG;인하/NNG,5,15,20,0.3021269393993915,Dovish
찰찰/NNG,19,49,68,0.3514537866482717,Dovish
인하/NNG;가능성/NNG;높/VA,14,27,41,0.4699752390657201,Dovish
원한다/VV,12,25,37,0.4350627927351237,Dovish
마찰/NNG,57,81,138,0.6378235387320487,Dovish
타이틀/NNG,8,16,24,0.4531904090990872,Dovish
아낌없이/MAG,9,13,22,0.6274944125987362,Dovish
체류/NNG,7,11,18,0.5767877933988383,Dovish
제조업/NNG;경기/NNG;위축/NNG,11,15,26,0.6646792666786613,Dovish
인플레이션/NNG;통제/NNG,20,24,44,0.7553173484984788,Dovish
김치프리미엄/NNG,3,16,19,0.1699464034121577,Dovish
모아야/VV,5,24,29,0.1888293371246197,Dovish
득표율/NNG,13,34,47,0.34655737166400785,Dovish
완만/NNG;금리/NNG;인하/NNG,8,10,18,0.7251046545585396,Dovish
원한다고/VV,11,14,25,0.7121563571557085,Dovish
열연/NNG,5,13,18,0.34860800699929784,Dovish
소방/NNG,7,13,20,0.48805120979901695,Dovish
수출국/NNG,55,92,147,0.5418580978358651,Dovish
고스란히/MAG,30,45,75,0.6042538787987829,Dovish
양해각서/NNG,9,11,20,0.7415843057985064,Dovish
그로스/NNG,14,20,34,0.6344665727387221,Dovish
드라이브/NNG,25,32,57,0.7081100142173238,Dovish
신아/NNG,8,12,20,0.604253878798783,Dovish
내걸/VV,10,19,29,0.47704253589377604,Dovish
소유주/NNG,12,15,27,0.7251046545585396,Dovish
기대/NNG;금리/NNG;인하/NNG,13,16,29,0.7364344147860167,Dovish
화환/NNG,17,29,46,0.5313266865299643,Dovish
마이너스통장/NNG,11,20,31,0.4985094500089959,Dovish
부채감축계획/NNG,8,22,30,0.32959302479933617,Dovish
시장조성/NNG,35,57,92,0.5565496252094053,Dovish
맞췄/VV,20,29,49,0.6250902194470168,Dovish
가추/NNG,4,27,31,0.1342786397330629,Dovish
증여/NNG,30,40,70,0.6797856136486308,Dovish
위험/NNG;배제/NNG,6,14,20,0.3884489220849319,Dovish
느껴진다/VV,12,15,27,0.7251046545585396,Dovish
기정사실화/NNG,70,85,155,0.7464312620455554,Dovish
처하/VV,15,22,37,0.6179869214987552,Dovish
경제/NNG;전망/NNG;상향/NNG,20,29,49,0.6250902194470168,Dovish
다자/NNG,8,10,18,0.7251046545585396,Dovish
기간조정/NNG,15,36,51,0.3776586742492393,Dovish
위인/NNG,9,11,20,0.7415843057985064,Dovish
금융감독당국/NNG,9,21,30,0.3884489220849319,Dovish
어려/VA,8,14,22,0.5179318961132426,Dovish
펀더멘털/NNG;부진/NNG,10,16,26,0.5664880113738591,Dovish
긴축/NNG;압력/NNG,7,10,17,0.6344665727387221,Dovish
엔저현상/NNG,16,20,36,0.7251046545585396,Dovish
듀레이션/NNG;위험/NNG,7,12,19,0.5287221439489351,Dovish
안정성/NNG;저하/NNG,11,14,25,0.7121563571557085,Dovish
생산가능인구/NNG,30,40,70,0.6797856136486308,Dovish
미정/NNG,75,100,175,0.6797856136486308,Dovish
점치/VV,96,128,224,0.6797856136486308,Dovish
자연재해/NNG,13,16,29,0.7364344147860167,Dovish
과밀/NNG,5,15,20,0.3021269393993915,Dovish
회사채/NNG;신용스프레드/NNG;확대/NNG,15,19,34,0.715563803840664,Dovish
가전제품/NNG,14,30,44,0.42297771515914806,Dovish
유동성비율/NNG,119,156,275,0.6914058805486073,Dovish
주택담보대출/NNG;늘/VV,7,12,19,0.5287221439489351,Dovish
쓰나미/NNG,5,37,42,0.12248389435110466,Dovish
비급여/NNG,2,17,19,0.10663303743507935,Dovish
조심/NNG,210,256,466,0.74351551492819,Dovish
끝낸/VV,7,12,19,0.5287221439489351,Dovish
경제/NNG;지표/NNG;혼조/NNG,10,16,26,0.5664880113738591,Dovish
연대보증/NNG,91,116,207,0.7110401246209817,Dovish
교시/NNG,10,14,24,0.6474148701415533,Dovish
수세/NNG,8,13,21,0.5577728111988766,Dovish
실효환율/NNG,57,79,136,0.6539709700923537,Dovish
대변인/NNG,44,70,114,0.5697250857245667,Dovish
평정/NNG,104,127,231,0.7422331109654341,Dovish
합작법인/NNG,8,11,19,0.6591860495986723,Dovish
안내/NNG,31,61,92,0.4606197600679247,Dovish
재정/NNG;건전/NNG,9,13,22,0.6274944125987362,Dovish
이변/NNG,14,26,40,0.48805120979901695,Dovish
휴전/NNG,89,121,210,0.6666768001622937,Dovish
우울/NNG,8,12,20,0.604253878798783,Dovish
업무보고/NNG,16,24,40,0.604253878798783,Dovish
춘절/NNG,20,39,59,0.46481067599906384,Dovish
이슬람금융/NNG,1,77,78,0.01177117945711915,Dovish
임대사업자/NNG,8,14,22,0.5179318961132426,Dovish
금리/NNG;상승/NNG;가능성/NNG;높/VA,9,11,20,0.7415843057985064,Dovish
자본/NNG;규제/NNG;강화/NNG,6,12,18,0.4531904090990872,Dovish
허들/NNG,33,48,81,0.623136812511245,Dovish
재환/NNG,5,14,19,0.32370743507077665,Dovish
유위/NNG,9,12,21,0.6797856136486309,Dovish
구미/NNG,6,13,19,0.4183296083991574,Dovish
발행희망금액/NNG,5,15,20,0.3021269393993915,Dovish
계리/NNG,8,22,30,0.32959302479933617,Dovish
긴급/NNG,206,281,487,0.6644642297111172,Dovish
정기적금/NNG,10,23,33,0.39407861660790194,Dovish
금채/NNG,14,18,32,0.7049628585985802,Dovish
자산/NNG;거품/NNG,14,29,43,0.43756315361291176,Dovish
이민/NNG,67,92,159,0.6600816828182358,Dovish
비대/NNG,9,14,23,0.5826733831273979,Dovish
금중/NNG,12,27,39,0.40283591919918865,Dovish
기업/NNG;성장/NNG,17,23,40,0.6699336482334333,Dovish
사채/NNG,937,1137,2074,0.7469470770903162,Dovish
이온/NNG,19,45,64,0.3826941232392292,Dovish
마군/NNG,4,39,43,0.09296213519981276,Dovish
종속회사/NNG,20,28,48,0.6474148701415533,Dovish
재정자금/NNG,10,12,22,0.7553173484984788,Dovish
신용정보원/NNG,4,20,24,0.1812761636396349,Dovish
가뭄/NNG,42,53,95,0.718264044609874,Dovish
상한/VV,46,61,107,0.6835002891330496,Dovish
etn/NNG,18,90,108,0.1812761636396349,Dovish
이머징채권/NNG,14,45,59,0.28198514343943204,Dovish
프로/NNG,73,102,175,0.6486843110633993,Dovish
생성/NNG,52,79,131,0.5966050955228489,Dovish
신문/NNG,363,452,815,0.7279120287741976,Dovish
분수령/NNG,20,24,44,0.7553173484984788,Dovish
글로벌/NNG;채권/NNG;금리/NNG;상승/NNG,3,19,22,0.1431127607681328,Dovish
이바지/NNG,6,11,17,0.49438953719900425,Dovish
경기평가보고서/NNG,5,34,39,0.13329129679384918,Dovish
글로벌/NNG;금리/NNG;하락/NNG,20,28,48,0.6474148701415533,Dovish
위험/NNG;작/VA,10,18,28,0.5035448989989859,Dovish
대출/NNG;줄/VV,11,14,25,0.7121563571557085,Dovish
보증금/NNG,92,145,237,0.5750830018912555,Dovish
놀랄/VV,17,22,39,0.7003851776985893,Dovish
급박/NNG,9,15,24,0.5438284909189047,Dovish
수익성/NNG;감소/NNG,8,10,18,0.7251046545585396,Dovish
군군/NNG,3,41,44,0.06632054767303715,Dovish
연립주택/NNG,10,12,22,0.7553173484984788,Dovish
지출/NNG;감소/NNG,18,24,42,0.6797856136486309,Dovish
랠리/NNG,500,720,1220,0.6294311237487322,Dovish
알파/NNG,33,72,105,0.4154245416741634,Dovish
호시/NNG,10,13,23,0.6972160139985957,Dovish
실적/NNG;불확실성/NNG,9,19,28,0.42933828230439847,Dovish
손익계산서/NNG,9,18,27,0.45319040909908725,Dovish
선상/NNG,10,13,23,0.6972160139985957,Dovish
요약/NNG,494,687,1181,0.6517498168703031,Dovish
출자자/NNG,8,10,18,0.7251046545585396,Dovish
배상/NNG,110,163,273,0.6116680368208539,Dovish
상장사/NNG,103,126,229,0.7409303513842219,Dovish
자동화/NNG,7,12,19,0.5287221439489351,Dovish
금리/NNG;인하/NNG;가능성/NNG;높/VA,32,40,72,0.7251046545585396,Dovish
극우/NNG,37,68,105,0.4931777981372419,Dovish
제철/NNG,20,30,50,0.604253878798783,Dovish
홍예/NNG,32,55,87,0.5273488396789379,Dovish
갑작/NNG,17,22,39,0.7003851776985893,Dovish
강북/NNG,9,14,23,0.5826733831273979,Dovish
제치/VV,21,26,47,0.7320768146985255,Dovish
中企/NNG,16,24,40,0.604253878798783,Dovish
종식/NNG,22,89,111,0.22404919101527904,Dovish
경제/NNG;전망/NNG;하향/NNG,24,36,60,0.604253878798783,Dovish
여력/NNG;확충/NNG,5,15,20,0.3021269393993915,Dovish
실업률/NNG;오르/VV,16,50,66,0.2900418618234158,Dovish
걸려/VV,17,23,40,0.6699336482334333,Dovish
신년사/NNG,9,16,25,0.5098392102364732,Dovish
유추/NNG,20,27,47,0.6713931986653144,Dovish
행계/NNG,22,65,87,0.3067750461593821,Dovish
아민/NNG,5,12,17,0.3776586742492394,Dovish
긴축/NNG;아니/VCN,8,12,20,0.604253878798783,Dovish
결제일/NNG,5,13,18,0.34860800699929784,Dovish
투기과열지구/NNG,12,17,29,0.639798224610476,Dovish
가리기/NNG,23,35,58,0.5956216805302289,Dovish
트리거/NNG,182,252,434,0.6546083686986816,Dovish
잔존액/NNG,35,71,106,0.4468074455906494,Dovish
정정불안/NNG,19,28,47,0.6150441266344755,Dovish
소재부품/NNG,10,17,27,0.5331651871753967,Dovish
서브/NNG,36,53,89,0.615654895379892,Dovish
거버넌스/NNG,40,232,272,0.1562725548617542,Dovish
거시변수/NNG,9,20,29,0.4078713681891785,Dovish
합성/NNG,126,153,279,0.7464312620455555,Dovish
별관/NNG,5,19,24,0.23852126794688802,Dovish
경제/NNG;견고/NNG,9,15,24,0.5438284909189047,Dovish
공신력/NNG,5,14,19,0.32370743507077665,Dovish
지수선물/NNG,72,101,173,0.6461328604977086,Dovish
국고채/NNG;금리/NNG;하락/NNG;금리/NNG;하락/NNG,8,34,42,0.2132660748701587,Dovish
소계/NNG,50,63,113,0.7193498557128368,Dovish
순매수금액/NNG,105,154,259,0.6179869214987553,Dovish
테너/NNG,135,265,400,0.461741171534919,Dovish
모델링/NNG,6,14,20,0.3884489220849319,Dovish
금리/NNG;높/VV,17,59,76,0.2611605747350672,Dovish
가계/NNG;대출/NNG;증가/NNG;둔화/NNG,16,21,37,0.6905758614843234,Dovish
모아질/VV,6,11,17,0.49438953719900425,Dovish
비상장사/NNG,10,17,27,0.5331651871753967,Dovish
긍정적/VAX;상승/NNG,7,11,18,0.5767877933988383,Dovish
건설기업/NNG,12,17,29,0.639798224610476,Dovish
리알/NNG,12,24,36,0.4531904090990872,Dovish
실적/NNG;우려/NNG,11,16,27,0.6231368125112449,Dovish
깜짝/MAG;금리/NNG;인하/NNG,18,38,56,0.42933828230439847,Dovish
합니다/VV,11,17,28,0.5864817058929364,Dovish
함수/NNG,17,49,66,0.31445865121161154,Dovish
소규모/NNG,100,126,226,0.7193498557128368,Dovish
추론/NNG,7,21,28,0.30212693939939145,Dovish
박스권/NNG,715,859,1574,0.7544380500718215,Dovish
표결/NNG,67,89,156,0.6823316271828953,Dovish
제소/NNG,5,15,20,0.3021269393993915,Dovish
채권/NNG;금리/NNG;오르/VV,12,20,32,0.5438284909189046,Dovish
부동자금/NNG,14,29,43,0.43756315361291176,Dovish
머지않/VA,34,66,100,0.46692345179905953,Dovish
아카데미/NNG,15,39,54,0.3486080069992978,Dovish
장애물/NNG,32,54,86,0.5371145589322516,Dovish
투자/NNG;비중/NNG;확대/NNG,11,14,25,0.7121563571557085,Dovish
보도/NNG,688,838,1526,0.7441408149407447,Dovish
다각/NNG,13,19,32,0.6201552966619088,Dovish
금융시장/NNG;부담/NNG,9,18,27,0.45319040909908725,Dovish
공인중개사/NNG,2,28,30,0.06474148701415533,Dovish
홍홍/MAG,5,15,20,0.3021269393993915,Dovish
금융시스템/NNG;불안/NNG,8,14,22,0.5179318961132426,Dovish
소셜/NNG,30,45,75,0.6042538787987829,Dovish
번지/NNG,65,102,167,0.5775956194400131,Dovish
대응책/NNG,50,68,118,0.666456483969246,Dovish
눈앞/NNG,44,58,102,0.6875992413917185,Dovish
수익/NNG;확보/NNG,13,27,40,0.43640557913245437,Dovish
마침내/MAG,26,38,64,0.6201552966619088,Dovish
aa-등급/NNG,145,196,341,0.6705368297894658,Dovish
농업금융채/NNG,3,17,20,0.159949556152619,Dovish
경기/NNG;불확실성/NNG;높/VA,23,28,51,0.7445271006627863,Dovish
일몰제/NNG,9,11,20,0.7415843057985064,Dovish
직관/NNG,16,27,43,0.5371145589322516,Dovish
문제점/NNG,64,84,148,0.6905758614843234,Dovish
유로스톡스50/NNG,37,51,88,0.6575703975163226,Dovish
증분/NNG,8,20,28,0.3625523272792698,Dovish
알리/VV,38,49,87,0.7029075732965434,Dovish
관대/NNG,10,12,22,0.7553173484984788,Dovish
의해서/VV,20,26,46,0.6972160139985957,Dovish
경제/NNG;성장률/NNG;하향/NNG,12,20,32,0.5438284909189046,Dovish
차기/NNG;금리/NNG;인상/NNG,8,10,18,0.7251046545585396,Dovish
성공리/NNG,6,11,17,0.49438953719900425,Dovish
경선/NNG,6,102,108,0.053316518717539674,Dovish
증거금/NNG,26,51,77,0.46207649555201047,Dovish
단칸지수/NNG,9,13,22,0.6274944125987362,Dovish
티티/NNG,15,21,36,0.6474148701415531,Dovish
조약/NNG,24,33,57,0.6591860495986723,Dovish
경기동향보고서/NNG,8,13,21,0.5577728111988766,Dovish
오피스텔/NNG,52,70,122,0.6733114649472153,Dovish
지표/NNG;fed/NNG;금리/NNG;인하/NNG,10,19,29,0.47704253589377604,Dovish
회사채/NNG;발행시장/NNG;강세/NNG,5,13,18,0.34860800699929784,Dovish
경기민감물가/NNG,6,12,18,0.4531904090990872,Dovish
갈아치우/VV,11,28,39,0.35607817857785423,Dovish
fed/NNG;예상/NNG;금리/NNG;인하/NNG,2,15,17,0.1208507757597566,Dovish
무역전쟁/NNG;우려/NNG,10,14,24,0.6474148701415533,Dovish
전망/NNG;양적완화/NNG;축소/NNG,8,10,18,0.7251046545585396,Dovish
불확실성/NNG;제거/NNG,11,27,38,0.3692662592659229,Dovish
기업/NNG;실적/NNG;부진/NNG,11,15,26,0.6646792666786613,Dovish
외화예금/NNG,40,67,107,0.5411228765362236,Dovish
각별히/MAG,8,10,18,0.7251046545585396,Dovish
경기/NNG;호전/NNG,6,11,17,0.49438953719900425,Dovish
접도/NNG,1,18,19,0.05035448989989858,Dovish
베이지북/NNG,112,154,266,0.6591860495986723,Dovish
예대마진/NNG;축소/NNG,5,12,17,0.3776586742492394,Dovish
냉랭/NNG,12,15,27,0.7251046545585396,Dovish
찾아온/VV,11,14,25,0.7121563571557085,Dovish
역레포/NNG,209,271,480,0.6990169409720238,Dovish
환경/NNG;불안/NNG,7,12,19,0.5287221439489351,Dovish
영업이익/NNG;흑자/NNG,6,11,17,0.49438953719900425,Dovish
아리/NNG,38,60,98,0.5740411848588438,Dovish
달러엔/NNG;상승/NNG,14,18,32,0.7049628585985802,Dovish
반발/NNG,126,197,323,0.5797156502181218,Dovish
이론/NNG,149,187,336,0.7221964808103102,Dovish
입국/NNG,19,35,54,0.4920353013075804,Dovish
절차/NNG,317,404,721,0.711194849922825,Dovish
향배/NNG,36,54,90,0.604253878798783,Dovish
경제주체/NNG;심리/NNG;위축/NNG,9,14,23,0.5826733831273979,Dovish
정통/NNG,20,27,47,0.6713931986653144,Dovish
미국식/NNG,5,21,26,0.21580495671385105,Dovish
금융시장/NNG;위험/NNG,13,17,30,0.6931147433280157,Dovish
기를/VV,5,14,19,0.32370743507077665,Dovish
적격/NNG,138,268,406,0.46671848101249286,Dovish
갤런/NNG,9,20,29,0.4078713681891785,Dovish
중금채/NNG,103,157,260,0.5946320017478469,Dovish
현금결제/NNG,7,17,24,0.37321563102277766,Dovish
아이비/NNG,18,30,48,0.5438284909189047,Dovish
합작/NNG,12,16,28,0.6797856136486308,Dovish
집권당/NNG,17,27,44,0.5706842188655172,Dovish
기불/NNG,7,10,17,0.6344665727387221,Dovish
승자/NNG,24,32,56,0.6797856136486308,Dovish
우려/NNG;경감/NNG,6,11,17,0.49438953719900425,Dovish
금융중심지/NNG,4,13,17,0.2788864055994383,Dovish
꼭짓점/NNG,2,17,19,0.10663303743507935,Dovish
fed/NNG;보유자산/NNG;축소/NNG,8,11,19,0.6591860495986723,Dovish
다양화/NNG,35,48,83,0.6609026799361688,Dovish
금리/NNG;인상/NNG;없/VA,22,28,50,0.7121563571557085,Dovish
경제/NNG;성장률/NNG;회복/NNG,9,13,22,0.6274944125987362,Dovish
홀홀/MAG,8,45,53,0.16113436767967546,Dovish
기업가/NNG,7,33,40,0.19226259779961277,Dovish
호소/NNG,27,33,60,0.7415843057985064,Dovish
못지/VA,11,18,29,0.5538993888988843,Dovish
가동/NNG;중단/NNG,8,13,21,0.5577728111988766,Dovish
관보/NNG,9,14,23,0.5826733831273979,Dovish
兩難/NNG,6,15,21,0.3625523272792698,Dovish
비유/NNG,27,34,61,0.7197730026867856,Dovish
수수료/NNG,297,482,779,0.5584960643254311,Dovish
cd/NNG;금리/NNG;하락/NNG,8,17,25,0.4265321497403174,Dovish
집회/NNG,23,28,51,0.7445271006627863,Dovish
국채/NNG;수익률/NNG;상승/NNG,20,28,48,0.6474148701415533,Dovish
용선료/NNG,5,23,28,0.19703930830395097,Dovish
영업이익률/NNG,193,247,440,0.7082246879038367,Dovish
과다/NNG,85,117,202,0.6584817909986737,Dovish
금리/NNG;인하/NNG;축소/NNG,13,19,32,0.6201552966619088,Dovish
수탁생산/NNG,25,30,55,0.7553173484984788,Dovish
순안정자금조달비율/NNG,7,10,17,0.6344665727387221,Dovish
불확실성/NNG;우려/NNG,7,11,18,0.5767877933988383,Dovish
민평/NNG;높/VA,10,13,23,0.6972160139985957,Dovish
목적인/NNG,6,16,22,0.3398928068243154,Dovish
고문/NNG,37,55,92,0.6097470958787718,Dovish
트래핑/NNG,21,61,82,0.3120327406911748,Dovish
규규/NNG,169,221,390,0.6931147433280157,Dovish
접수/NNG,65,78,143,0.7553173484984786,Dovish
반사이익/NNG,30,47,77,0.5785409477860687,Dovish
조양/NNG,6,11,17,0.49438953719900425,Dovish
우여곡절/NNG,6,13,19,0.4183296083991574,Dovish
만기일시상환/NNG,8,36,44,0.20141795959959433,Dovish
거둔/VV,27,42,69,0.5826733831273978,Dovish
은행/NNG;수익성/NNG;악화/NNG,8,12,20,0.604253878798783,Dovish
브리지/NNG,8,10,18,0.7251046545585396,Dovish
에피/NNG,7,11,18,0.5767877933988383,Dovish
승객/NNG,7,10,17,0.6344665727387221,Dovish
글로벌/NNG;금융시장/NNG;안정/NNG,7,16,23,0.3965416079617013,Dovish
받아들이/VV,164,206,370,0.7215847290509738,Dovish
궁금증/NNG,9,14,23,0.5826733831273979,Dovish
환율정책/NNG,27,34,61,0.7197730026867856,Dovish
고소/NNG,15,18,33,0.7553173484984786,Dovish
호조/NNG;금리/NNG;상승/NNG,7,10,17,0.6344665727387221,Dovish
트러스트/NNG,10,20,30,0.45319040909908725,Dovish
유관/NNG,21,28,49,0.6797856136486309,Dovish
합의안/NNG,34,52,86,0.5926336118988063,Dovish
매입자금/NNG,8,16,24,0.4531904090990872,Dovish
주국/NNG,11,25,36,0.3988075600071967,Dovish
금리/NNG;전망/NNG;하향/NNG,8,10,18,0.7251046545585396,Dovish
도크/NNG;스프레드/NNG;축소/NNG,6,13,19,0.4183296083991574,Dovish
정오/NNG,27,37,64,0.6614130294959651,Dovish
사모사채/NNG,66,82,148,0.7295260244034087,Dovish
수청/NNG,7,12,19,0.5287221439489351,Dovish
고용시장/NNG;견고/NNG,8,12,20,0.604253878798783,Dovish
점프/NNG,9,11,20,0.7415843057985064,Dovish
뛴다/VV,9,13,22,0.6274944125987362,Dovish
유로존/NNG;경기/NNG;개선/NNG,8,13,21,0.5577728111988766,Dovish
스튜어드/NNG,2,24,26,0.07553173484984788,Dovish
부추기/VV,122,149,271,0.7421373142293778,Dovish
투자/NNG;모멘텀/NNG,11,15,26,0.6646792666786613,Dovish
본질/NNG,87,105,192,0.7510012493642017,Dovish
위험가중치/NNG,25,50,75,0.4531904090990872,Dovish
운행/NNG,9,35,44,0.23306935325095915,Dovish
저층/NNG,8,16,24,0.4531904090990872,Dovish
요구자본/NNG,20,33,53,0.5493217079988937,Dovish
명암/NNG,11,18,29,0.5538993888988843,Dovish
추세분석/NNG,7,11,18,0.5767877933988383,Dovish
입주자/NNG,14,20,34,0.6344665727387221,Dovish
소셜미디어/NNG,46,75,121,0.5559135684948804,Dovish
전해질/VV,4,19,23,0.19081701435751042,Dovish
투자심리/NNG;저하/NNG,9,18,27,0.45319040909908725,Dovish
사퇴/NNG,34,64,98,0.48151480966778015,Dovish
상식/NNG,23,31,54,0.6724760909212262,Dovish
안목/NNG,5,15,20,0.3021269393993915,Dovish
생산능력/NNG,56,77,133,0.6591860495986723,Dovish
오렌지/NNG,6,14,20,0.3884489220849319,Dovish
쇼핑센터/NNG,8,17,25,0.4265321497403174,Dovish
생산/NNG;호조/NNG,7,13,20,0.48805120979901695,Dovish
가닥/NNG,22,41,63,0.4863506829356058,Dovish
가파/NNG,27,34,61,0.7197730026867856,Dovish
금리/NNG;인상/NNG;기대/NNG;높/VA,8,10,18,0.7251046545585396,Dovish
인플레이션/NNG;꺾/VV,7,21,28,0.30212693939939145,Dovish
판정/NNG,56,70,126,0.7251046545585396,Dovish
내재변동성/NNG,10,22,32,0.41199128099917026,Dovish
창당/NNG,11,17,28,0.5864817058929364,Dovish
대상/NNG,1770,2133,3903,0.7521303554668395,Dovish
위험액/NNG,14,20,34,0.6344665727387221,Dovish
거래소/NNG,154,237,391,0.588956312246915,Dovish
설립자/NNG,26,51,77,0.46207649555201047,Dovish
고점/NNG;부담/NNG,3,34,37,0.0799747780763095,Dovish
완화정책/NNG,343,616,959,0.5046893192239835,Dovish
자문위원/NNG,8,17,25,0.4265321497403174,Dovish
정전/NNG,16,22,38,0.6591860495986723,Dovish
대법원/NNG,29,45,74,0.5841120828388235,Dovish
가설/NNG,8,10,18,0.7251046545585396,Dovish
중장기재무관리계획/NNG,12,26,38,0.4183296083991574,Dovish
전향/NNG,23,28,51,0.7445271006627863,Dovish
순은/NNG,19,26,45,0.6623552132986659,Dovish
의혹/NNG,49,93,142,0.4775554848571027,Dovish
필립스곡선/NNG,34,44,78,0.7003851776985893,Dovish
초미/NNG,9,15,24,0.5438284909189047,Dovish
감사보고서/NNG,43,70,113,0.5567767883217357,Dovish
지사/NNG,20,25,45,0.7251046545585396,Dovish
발사체/NNG,7,11,18,0.5767877933988383,Dovish
호우/NNG,4,13,17,0.2788864055994383,Dovish
반대매매/NNG,12,20,32,0.5438284909189046,Dovish
다보스포럼/NNG,7,18,25,0.3524814292992901,Dovish
선거/NNG,636,801,1437,0.7196731590187752,Dovish
공지/NNG,47,72,119,0.5916652563238084,Dovish
구제금융안/NNG,6,37,43,0.14698067322132558,Dovish
채권/NNG;금리/NNG;하향/NNG;안정/NNG,14,17,31,0.7464312620455553,Dovish
경제/NNG;강하/VA,18,29,47,0.5625811975023152,Dovish
예정일/NNG,56,76,132,0.6678595502512864,Dovish
곧곧/NNG,7,15,22,0.42297771515914806,Dovish
가격/NNG;고점/NNG,8,12,20,0.604253878798783,Dovish
콘탱고/NNG,7,10,17,0.6344665727387221,Dovish
목록/NNG,44,57,101,0.699662385977538,Dovish
외화증권/NNG,16,28,44,0.5179318961132426,Dovish
만기비중/NNG,12,16,28,0.6797856136486308,Dovish
전고/NNG,8,11,19,0.6591860495986723,Dovish
본일/NNG,68,117,185,0.526785432798939,Dovish
티어/NNG,12,31,43,0.35085709091542233,Dovish
소나/NNG,65,102,167,0.5775956194400131,Dovish
피한/VV,7,11,18,0.5767877933988383,Dovish
티티/MAG,7,22,29,0.28839389669941917,Dovish
심천/NNG,10,16,26,0.5664880113738591,Dovish
버스트/NNG,8,10,18,0.7251046545585396,Dovish
정확도/NNG,9,14,23,0.5826733831273979,Dovish
비효율/NNG,14,19,33,0.6678595502512864,Dovish
환노출/NNG,18,25,43,0.6525941891026856,Dovish
은퇴/NNG,60,81,141,0.6713931986653143,Dovish
반기/NNG,166,205,371,0.7339473942482779,Dovish
기본급/NNG,9,21,30,0.3884489220849319,Dovish
기술혁신/NNG,16,31,47,0.46780945455389644,Dovish
기대수명/NNG,3,22,25,0.12359738429975106,Dovish
참참/NNG,25,58,83,0.39068138715438555,Dovish
쿼트/NNG,4,21,25,0.17264396537108084,Dovish
예상/NNG;감소/NNG,17,21,38,0.7337368528270936,Dovish
사용권/NNG,3,15,18,0.1812761636396349,Dovish
음수/NNG,10,13,23,0.6972160139985957,Dovish
이코노믹스/NNG,72,99,171,0.6591860495986723,Dovish
전망/NNG;낙관/NNG,8,11,19,0.6591860495986723,Dovish
對中/NNG,15,19,34,0.715563803840664,Dovish
금리/NNG;종료/NNG,9,11,20,0.7415843057985064,Dovish
경각심/NNG,18,25,43,0.6525941891026856,Dovish
리더십/NNG,34,41,75,0.7516328736277544,Dovish
대단/NNG,8,13,21,0.5577728111988766,Dovish
수탁/NNG,25,57,82,0.39753544657814666,Dovish
대중교통/NNG,15,22,37,0.6179869214987552,Dovish
장기차입금/NNG,14,30,44,0.42297771515914806,Dovish
투쟁/NNG,8,24,32,0.3021269393993915,Dovish
평정심/NNG,1,30,31,0.03021269393993915,Dovish
관차/NNG,6,12,18,0.4531904090990872,Dovish
고원/NNG,3,47,50,0.057854094778606875,Dovish
리뉴얼/NNG,8,11,19,0.6591860495986723,Dovish
선대/NNG,23,29,52,0.7188537523640693,Dovish
태양열/NNG,7,15,22,0.42297771515914806,Dovish
속성/NNG,59,96,155,0.557046544517628,Dovish
우량기업/NNG,70,98,168,0.6474148701415532,Dovish
초과지준/NNG,58,108,166,0.48676006903235297,Dovish
출근/NNG,10,12,22,0.7553173484984788,Dovish
스코어/NNG,17,49,66,0.31445865121161154,Dovish
헤드라인/NNG;물가/NNG;상승/NNG,14,17,31,0.7464312620455553,Dovish
신형/NNG,13,29,42,0.40630864264056094,Dovish
미인/NNG,10,16,26,0.5664880113738591,Dovish
초순/NNG,10,22,32,0.41199128099917026,Dovish
오차범위/NNG,10,13,23,0.6972160139985957,Dovish
기상/NNG,50,76,126,0.5963031698672201,Dovish
아트/NNG,7,14,21,0.45319040909908725,Dovish
스토어/NNG,7,11,18,0.5767877933988383,Dovish
도로/MAG,5,12,17,0.3776586742492394,Dovish
청신호/NNG,34,45,79,0.6848210626386206,Dovish
내쉬/VV,5,19,24,0.23852126794688802,Dovish
자산관리/NNG,173,265,438,0.5917127605595629,Dovish
등록금/NNG,5,17,22,0.26658259358769837,Dovish
체인저/NNG,10,22,32,0.41199128099917026,Dovish
메인스트리트/NNG,5,18,23,0.25177244949949296,Dovish
가치주/NNG,25,46,71,0.49259827075987744,Dovish
예상/NNG;상승/NNG;밑돌/VV,10,12,22,0.7553173484984788,Dovish
비결/NNG,12,22,34,0.49438953719900425,Dovish
독일채/NNG,38,59,97,0.5837706964666208,Dovish
묶여/VV,26,35,61,0.6733114649472153,Dovish
시리아사태/NNG,9,15,24,0.5438284909189047,Dovish
들어야/VV,6,13,19,0.4183296083991574,Dovish
당면/NNG,28,46,74,0.5517100632510628,Dovish
원루/NNG,80,98,178,0.7399027087332037,Dovish
구사/NNG,18,24,42,0.6797856136486309,Dovish
경제/NNG;지탱/NNG,8,13,21,0.5577728111988766,Dovish
나기/NNG,12,21,33,0.5179318961132425,Dovish
맞닿/VV,9,13,22,0.6274944125987362,Dovish
틀림없이/MAG,8,10,18,0.7251046545585396,Dovish
국민행복기금/NNG,1,27,28,0.03356965993326572,Dovish
걸쳐서/VV,11,15,26,0.6646792666786613,Dovish
세웠/VV,27,35,62,0.6992080597528775,Dovish
찝찝/NNG,3,14,17,0.19422446104246596,Dovish
일시/MAG,81,106,187,0.6926117573023786,Dovish
간다/VV,66,79,145,0.7572295443174623,Dovish
서방/NNG,68,117,185,0.526785432798939,Dovish
문자/NNG,15,20,35,0.6797856136486308,Dovish
타운/NNG,28,36,64,0.7049628585985802,Dovish
gni/NNG,18,37,55,0.4409420196639768,Dovish
예상/NNG;깨/VV,9,15,24,0.5438284909189047,Dovish
지니/NNG,44,74,118,0.5389291351448604,Dovish
진흥공단/NNG,34,56,90,0.5503026396203202,Dovish
화살표/NNG,8,15,23,0.4834031030390264,Dovish
홀로/MAG,72,92,164,0.7093415098942235,Dovish
일자리/NNG;감소/NNG,8,15,23,0.4834031030390264,Dovish
로유/NNG,30,36,66,0.7553173484984786,Dovish
로컬통화/NNG,54,121,175,0.40450053043554896,Dovish
오르막길/NNG,2,55,57,0.032959302479933617,Dovish
정제설비/NNG,2,17,19,0.10663303743507935,Dovish
먹구름/NNG,18,57,75,0.2862255215362656,Dovish
물적분할/NNG,18,34,52,0.47984866845785706,Dovish
나온다고/VV,10,12,22,0.7553173484984788,Dovish
외수/NNG,5,15,20,0.3021269393993915,Dovish
온도차/NNG,37,67,104,0.5005386607960067,Dovish
안정/NNG;성장/NNG,19,32,51,0.5381636108051661,Dovish
기초자산/NNG,201,272,473,0.6697887663890921,Dovish
토론/NNG,74,90,164,0.7452464505184989,Dovish
순이익/NNG;줄/VV,6,11,17,0.49438953719900425,Dovish
납득/NNG,13,17,30,0.6931147433280157,Dovish
업과/NNG,14,27,41,0.4699752390657201,Dovish
유동성/NNG;불안/NNG,8,15,23,0.4834031030390264,Dovish
손해/NNG,36,43,79,0.7588304524449833,Dovish
디플레이션/NNG;경기/NNG;침체/NNG,5,39,44,0.11620266899976596,Dovish
메타버스/NNG,22,27,49,0.7385325185318458,Dovish
시네/VV,11,41,52,0.2431753414678029,Dovish
선보인/VV,14,17,31,0.7464312620455553,Dovish
가목/NNG,7,12,19,0.5287221439489351,Dovish
비효율성/NNG,6,11,17,0.49438953719900425,Dovish
회사채/NNG;금리/NNG;상승/NNG,8,17,25,0.4265321497403174,Dovish
수익원/NNG,14,18,32,0.7049628585985802,Dovish
핵보유국/NNG,6,17,23,0.319899112305238,Dovish
라디오/NNG,9,22,31,0.3707921528992532,Dovish
고정금리부/NNG,9,18,27,0.45319040909908725,Dovish
장학금/NNG,12,38,50,0.2862255215362656,Dovish
언더퍼폼/NNG,110,143,253,0.6972160139985958,Dovish
fed/NNG;금리/NNG;내리/VV;않/VX,4,16,20,0.2265952045495436,Dovish
반사/NNG,20,48,68,0.3776586742492394,Dovish
본국/NNG,23,46,69,0.45319040909908725,Dovish
조성계획/NNG,2,15,17,0.1208507757597566,Dovish
봄철/NNG,7,34,41,0.18660781551138883,Dovish
진료/NNG,30,55,85,0.4943895371990042,Dovish
양회/NNG,23,94,117,0.2217740299846597,Dovish
코커스/NNG,12,26,38,0.4183296083991574,Dovish
채권시장/NNG;긍정적/VAX,20,29,49,0.6250902194470168,Dovish
자금/NNG;조달/NNG;어렵/VA,12,22,34,0.49438953719900425,Dovish
상환청구권/NNG,7,24,31,0.26436107197446757,Dovish
정책/NNG;긴축/NNG,11,17,28,0.5864817058929364,Dovish
소매/NNG;판매/NNG;호조/NNG,16,20,36,0.7251046545585396,Dovish
갇히/VV,7,13,20,0.48805120979901695,Dovish
험난/NNG,26,34,60,0.6931147433280157,Dovish
채무조정/NNG,71,87,158,0.7396900930123033,Dovish
금리/NNG;인하/NNG;가능성/NNG;상승/NNG,6,11,17,0.49438953719900425,Dovish
지켜본/VV,15,20,35,0.6797856136486308,Dovish
그렉시트/NNG,18,36,54,0.45319040909908725,Dovish
크레딧라인/NNG,5,12,17,0.3776586742492394,Dovish
생생/NNG,27,47,74,0.5206868530074619,Dovish
인스타그램/NNG,8,12,20,0.604253878798783,Dovish
안정화/NNG;추세/NNG,12,19,31,0.5724510430725313,Dovish
시인/NNG,24,33,57,0.6591860495986723,Dovish
설설/NNG,6,24,30,0.2265952045495436,Dovish
면밀/NNG,67,86,153,0.7061338932474149,Dovish
기업수/NNG,52,81,133,0.5818741055099391,Dovish
농금채/NNG,25,32,57,0.7081100142173238,Dovish
치우친/VV,6,12,18,0.4531904090990872,Dovish
열쇠/NNG,16,20,36,0.7251046545585396,Dovish
나눴/VV,8,12,20,0.604253878798783,Dovish
세월호참사/NNG,12,23,35,0.4728943399294823,Dovish
설득/NNG,27,35,62,0.6992080597528775,Dovish
금융경제/NNG,111,141,252,0.7135338356028182,Dovish
국중/NNG,98,155,253,0.5730665818285232,Dovish
막강/NNG,7,11,18,0.5767877933988383,Dovish
터지/VV,78,96,174,0.7364344147860168,Dovish
무한정/NNG,5,17,22,0.26658259358769837,Dovish
순대외채권/NNG,7,12,19,0.5287221439489351,Dovish
유타/NNG,19,23,42,0.7487493715550136,Dovish
살펴봐도/VV,9,13,22,0.6274944125987362,Dovish
전환사채/NNG,42,72,114,0.5287221439489351,Dovish
글로벌본드/NNG,26,33,59,0.7141182203985617,Dovish
증기/NNG,9,14,23,0.5826733831273979,Dovish
자력/NNG,8,15,23,0.4834031030390264,Dovish
디플레이션/NNG;탈출/NNG,7,18,25,0.3524814292992901,Dovish
발현/NNG,60,76,136,0.715563803840664,Dovish
상호/MAG,39,87,126,0.406308642640561,Dovish
회계기준/NNG,26,42,68,0.5610928874560127,Dovish
약식/NNG,8,18,26,0.40283591919918865,Dovish
마라톤/NNG,11,17,28,0.5864817058929364,Dovish
독주/NNG,11,20,31,0.4985094500089959,Dovish
장기투자기관/NNG,140,174,314,0.7292719226881863,Dovish
허용/NNG,235,296,531,0.7195928793127399,Dovish
자산/NNG;건전성/NNG;악화/NNG,10,13,23,0.6972160139985957,Dovish
유화/NNG,9,14,23,0.5826733831273979,Dovish
ecb/NNG;완화/NNG,16,22,38,0.6591860495986723,Dovish
국고채/NNG;발행/NNG;부담/NNG,8,10,18,0.7251046545585396,Dovish
신고점/NNG,8,22,30,0.32959302479933617,Dovish
아비/NNG,7,11,18,0.5767877933988383,Dovish
일시적/VAX;약세/NNG,7,13,20,0.48805120979901695,Dovish
보령/NNG,19,36,55,0.47836765404903653,Dovish
구제금융/NNG,167,463,630,0.3269235348576569,Dovish
리파이낸싱/NNG,64,89,153,0.6517794647717209,Dovish
원고/NNG,6,13,19,0.4183296083991574,Dovish
액도/NNG,19,27,46,0.6378235387320487,Dovish
풍림/NNG,7,16,23,0.3965416079617013,Dovish
프라이스/NNG,7,12,19,0.5287221439489351,Dovish
담보권/NNG,6,14,20,0.3884489220849319,Dovish
고작/MAG,10,12,22,0.7553173484984788,Dovish
상임/NNG,23,30,53,0.6948919606186005,Dovish
도덕/NNG,6,11,17,0.49438953719900425,Dovish
달러인덱스/NNG;내리/VV,6,11,17,0.49438953719900425,Dovish
도쿄/NNG,442,633,1075,0.632891503386403,Dovish
경연/NNG,4,16,20,0.2265952045495436,Dovish
카플란/NNG,13,21,34,0.5610928874560127,Dovish
할인율/NNG,45,61,106,0.6686415871953746,Dovish
정교/NNG,23,34,57,0.6131399652517062,Dovish
신용위험/NNG;완화/NNG,9,12,21,0.6797856136486309,Dovish
소매/NNG;판매/NNG;상승/NNG,8,14,22,0.5179318961132426,Dovish
건설/NNG;경기/NNG;부진/NNG,7,10,17,0.6344665727387221,Dovish
코인/NNG,148,200,348,0.6707218054666491,Dovish
신제품/NNG,32,40,72,0.7251046545585396,Dovish
반작용/NNG,41,78,119,0.47643094289904037,Dovish
합병/NNG,135,237,372,0.5162928711255423,Dovish
복병/NNG,25,34,59,0.666456483969246,Dovish
공채/NNG,10,21,31,0.4316099134277021,Dovish
유로존/NNG;경기/NNG;부진/NNG,9,13,22,0.6274944125987362,Dovish
파격/NNG,8,17,25,0.4265321497403174,Dovish
활기차/VA,4,15,19,0.2417015515195132,Dovish
축구/NNG,9,24,33,0.33989280682431544,Dovish
공개시장조작/NNG,35,74,109,0.42869363022886625,Dovish
유수/NNG,4,13,17,0.2788864055994383,Dovish
덕택/NNG,18,25,43,0.6525941891026856,Dovish
장벽/NNG,14,34,48,0.37321563102277766,Dovish
베이/NNG,32,47,79,0.61711034430514,Dovish
세제/NNG,142,197,339,0.6533303359601054,Dovish
초과이익/NNG,4,89,93,0.040736216548232555,Dovish
물러선/VV,8,12,20,0.604253878798783,Dovish
채권/NNG;약세/NNG,25,31,56,0.7309522727404633,Dovish
순응성/NNG,4,13,17,0.2788864055994383,Dovish
오버랩/NNG,6,15,21,0.3625523272792698,Dovish
완화/NNG;되돌/VV,6,13,19,0.4183296083991574,Dovish
광풍/NNG,7,10,17,0.6344665727387221,Dovish
견해/NNG,781,944,1725,0.7498765031914981,Dovish
누그러질/VV,17,22,39,0.7003851776985893,Dovish
뒤바뀌/VV,6,12,18,0.4531904090990872,Dovish
알리/NNG,12,37,49,0.29396134644265115,Dovish
기업/NNG;이익/NNG;성장/NNG,8,10,18,0.7251046545585396,Dovish
색상/NNG,9,12,21,0.6797856136486309,Dovish
경제/NNG;위축/NNG,9,11,20,0.7415843057985064,Dovish
수량/NNG,519,825,1344,0.5701959329028515,Dovish
승한/VV,8,15,23,0.4834031030390264,Dovish
사무총장/NNG,7,28,35,0.22659520454954363,Dovish
각신/NNG,2,19,21,0.09540850717875521,Dovish
결말/NNG,10,23,33,0.39407861660790194,Dovish
목별/NNG,9,11,20,0.7415843057985064,Dovish
gdp/NNG;감소/NNG,10,15,25,0.604253878798783,Dovish
기념/NNG,52,66,118,0.7141182203985617,Dovish
상해/VV,11,14,25,0.7121563571557085,Dovish
대명/NNG,10,16,26,0.5664880113738591,Dovish
선거구/NNG,11,14,25,0.7121563571557085,Dovish
일면/NNG,8,11,19,0.6591860495986723,Dovish
리필/NNG,35,54,89,0.5874690488321501,Dovish
약하/VA;지지/NNG;않/VX,11,15,26,0.6646792666786613,Dovish
건전성/NNG;위험/NNG,9,16,25,0.5098392102364732,Dovish
뚜렷이/MAG,14,19,33,0.6678595502512864,Dovish
투기지역/NNG,2,22,24,0.08239825619983404,Dovish
갭투자/NNG,11,22,33,0.4531904090990872,Dovish
관광업/NNG,10,14,24,0.6474148701415533,Dovish
해약/NNG,14,50,64,0.2537866290954888,Dovish
덕우/NNG,7,16,23,0.3965416079617013,Dovish
아메리칸/NNG,14,39,53,0.32536747319934467,Dovish
기호/NNG,7,23,30,0.2758550316255314,Dovish
소개/NNG,176,244,420,0.6537828852576996,Dovish
차치/NNG,13,16,29,0.7364344147860167,Dovish
만기수익률/NNG,276,422,698,0.592798828963735,Dovish
적자국채발행/NNG;증가/NNG,7,13,20,0.48805120979901695,Dovish
잠복/NNG,5,13,18,0.34860800699929784,Dovish
보유비율/NNG,15,26,41,0.5229120104989468,Dovish
양방향/NNG,38,52,90,0.6623552132986659,Dovish
물품/NNG,25,32,57,0.7081100142173238,Dovish
유니콘/NNG,4,13,17,0.2788864055994383,Dovish
스키/NNG,9,11,20,0.7415843057985064,Dovish
인위적/VAX,57,68,125,0.7597603917249404,Dovish
무모/NNG,6,12,18,0.4531904090990872,Dovish
불어났/VV,8,11,19,0.6591860495986723,Dovish
변동성/NNG;안정/NNG,8,10,18,0.7251046545585396,Dovish
전환점/NNG,24,45,69,0.48340310303902634,Dovish
고령자/NNG,14,32,46,0.3965416079617013,Dovish
경기소비재/NNG,20,60,80,0.3021269393993915,Dovish
신청서/NNG,13,16,29,0.7364344147860167,Dovish
고용/NNG;불안/NNG,8,14,22,0.5179318961132426,Dovish
국고채/NNG;금리/NNG;저점/NNG,8,10,18,0.7251046545585396,Dovish
정비/NNG,129,164,293,0.7129458874851494,Dovish
선점/NNG,18,25,43,0.6525941891026856,Dovish
자격/NNG,58,99,157,0.5310109843989306,Dovish
오토/NNG,131,223,354,0.5324479245917526,Dovish
비해선/VV,7,12,19,0.5287221439489351,Dovish
채권시장/NNG;악재/NNG,10,13,23,0.6972160139985957,Dovish
흥흥/MAG,45,66,111,0.6179869214987553,Dovish
저신용자/NNG,38,46,84,0.7487493715550136,Dovish
명품/NNG,16,25,41,0.5800837236468316,Dovish
하방/NNG;위험/NNG;금리/NNG;인상/NNG,9,13,22,0.6274944125987362,Dovish
원달러/NNG;오르/VV,8,16,24,0.4531904090990872,Dovish
경제/NNG;지표/NNG;악화/NNG,13,31,44,0.3800951818250409,Dovish
기어/NNG,3,14,17,0.19422446104246596,Dovish
투기자금/NNG,10,20,30,0.45319040909908725,Dovish
위성/NNG,23,34,57,0.6131399652517062,Dovish
리수/NNG,6,12,18,0.4531904090990872,Dovish
전망/NNG;축소/NNG,12,19,31,0.5724510430725313,Dovish
껑충/MAG,15,20,35,0.6797856136486308,Dovish
예상/NNG;줄/VV,14,21,35,0.6042538787987829,Dovish
보간법/NNG,59,84,143,0.6366246223058606,Dovish
물가/NNG;상승률/NNG;농산물/NNG;가격/NNG;하락/NNG,5,12,17,0.3776586742492394,Dovish
무난히/MAG,48,60,108,0.7251046545585396,Dovish
공연장/NNG,4,20,24,0.1812761636396349,Dovish
진작/NNG;효과/NNG,13,21,34,0.5610928874560127,Dovish
도입/NNG,1199,1484,2683,0.7323117257544549,Dovish
화학제품/NNG,19,25,44,0.6888494218306125,Dovish
개선/NNG;제약/NNG,6,11,17,0.49438953719900425,Dovish
발병/NNG,4,22,26,0.16479651239966808,Dovish
원하/VV,117,153,270,0.6931147433280158,Dovish
점쳐진다/VV,8,20,28,0.3625523272792698,Dovish
국채/NNG;수익률/NNG;하락/NNG,9,18,27,0.45319040909908725,Dovish
마이크/NNG,6,21,27,0.25896594805662126,Dovish
건전화/NNG,54,72,126,0.6797856136486309,Dovish
돈다/VV,10,20,30,0.45319040909908725,Dovish
당첨/NNG,11,23,34,0.4334864782686921,Dovish
fed/NNG;금리/NNG;내리/VV,72,97,169,0.6727775145388512,Dovish
당위/NNG,27,40,67,0.6118070522837677,Dovish
어쩌면/MAG,58,72,130,0.7301401035485295,Dovish
결재/NNG,7,18,25,0.3524814292992901,Dovish
정책/NNG;확대/NNG,4,18,22,0.20141795959959433,Dovish
힌트/NNG,103,132,235,0.7072516990485755,Dovish
시발점/NNG,13,25,38,0.4713180254630507,Dovish
나누/VV,65,86,151,0.6850552695683876,Dovish
국채/NNG;강세/NNG,14,24,38,0.5287221439489351,Dovish
응급/NNG,8,16,24,0.4531904090990872,Dovish
축산/NNG,11,17,28,0.5864817058929364,Dovish
국채/NNG;무제한/NNG,8,12,20,0.604253878798783,Dovish
커뮤니티/NNG,101,149,250,0.6143923666980914,Dovish
에어로졸/NNG,2,15,17,0.1208507757597566,Dovish
헤어컷/NNG,6,12,18,0.4531904090990872,Dovish
성북/NNG,9,19,28,0.42933828230439847,Dovish
법정/NNG,48,61,109,0.7132176930083995,Dovish
유감/NNG,5,14,19,0.32370743507077665,Dovish
fed/NNG;통화/NNG;완화/NNG,7,10,17,0.6344665727387221,Dovish
fed/NNG;금리/NNG;상승/NNG,5,15,20,0.3021269393993915,Dovish
투자/NNG;감소/NNG,18,28,46,0.5826733831273979,Dovish
총알/NNG,7,10,17,0.6344665727387221,Dovish
공휴일/NNG,25,30,55,0.7553173484984788,Dovish
한꺼번에/MAG,33,41,74,0.7295260244034087,Dovish
기한이익상실/NNG,20,29,49,0.6250902194470168,Dovish
초대/NNG,42,90,132,0.42297771515914806,Dovish
사각지대/NNG,14,26,40,0.48805120979901695,Dovish
전망/NNG;강화/NNG,43,63,106,0.6186408759130397,Dovish
신인도/NNG,35,52,87,0.6100640122487712,Dovish
위헌/NNG,13,25,38,0.4713180254630507,Dovish
보베스파/NNG,10,17,27,0.5331651871753967,Dovish
트럼프케어/NNG,8,14,22,0.5179318961132426,Dovish
낙인효과/NNG,9,21,30,0.3884489220849319,Dovish
접속/NNG,12,15,27,0.7251046545585396,Dovish
국비/NNG,9,11,20,0.7415843057985064,Dovish
준하/VV,32,39,71,0.7436970815985021,Dovish
특특/NNG,164,205,369,0.7251046545585396,Dovish
삼일절/NNG,6,16,22,0.3398928068243154,Dovish
피사/NNG,7,10,17,0.6344665727387221,Dovish
출산/NNG,54,67,121,0.7305158833239018,Dovish
신용스프레드/NNG;하락/NNG,10,22,32,0.41199128099917026,Dovish
위크/NNG,13,20,33,0.5891475318288134,Dovish
송주/NNG,23,31,54,0.6724760909212262,Dovish
수요/NNG;호조/NNG,7,10,17,0.6344665727387221,Dovish
매일/MAG,131,170,301,0.6984463951997697,Dovish
국고채/NNG;상승/NNG,50,60,110,0.7553173484984788,Dovish
정치/NNG;불확실성/NNG;높/VA,9,11,20,0.7415843057985064,Dovish
위험/NNG;상승/NNG,13,23,36,0.5123022015902725,Dovish
소부/NNG,6,12,18,0.4531904090990872,Dovish
늦/VA;인하/NNG,7,10,17,0.6344665727387221,Dovish
서치/NNG,65,279,344,0.21116398990280047,Dovish
응원/NNG,10,12,22,0.7553173484984788,Dovish
무료/NNG,34,41,75,0.7516328736277544,Dovish
사회당/NNG,23,33,56,0.6317199641987277,Dovish
시아/NNG,16,20,36,0.7251046545585396,Dovish
사건/NNG,163,201,364,0.7350252406283703,Dovish
로티/NNG,33,43,76,0.6955945814079014,Dovish
외생/NNG,21,34,55,0.5598234465341665,Dovish
이익/NNG;개선/NNG,18,28,46,0.5826733831273979,Dovish
은행/NNG;금리/NNG;인하/NNG,8,13,21,0.5577728111988766,Dovish
강진/NNG,35,60,95,0.5287221439489351,Dovish
예외적/VAX,56,71,127,0.7148919129450391,Dovish
제너럴/NNG,25,35,60,0.6474148701415532,Dovish
오케이/NNG,7,10,17,0.6344665727387221,Dovish
본토기업/NNG,11,14,25,0.7121563571557085,Dovish
생산/NNG;부진/NNG,8,11,19,0.6591860495986723,Dovish
전망/NNG;하향/NNG;금리/NNG;인하/NNG,4,13,17,0.2788864055994383,Dovish
신탁/NNG,230,310,540,0.6724760909212263,Dovish
펀더멘털/NNG;우려/NNG,44,53,97,0.7524670943532014,Dovish
소기/NNG,22,31,53,0.6432380000116076,Dovish
기타금융기관/NNG,18,22,40,0.7415843057985064,Dovish
배분/NNG,148,202,350,0.6640809955115337,Dovish
융통/NNG,20,53,73,0.3420304974332734,Dovish
신종플루/NNG,8,13,21,0.5577728111988766,Dovish
퍼즐/NNG,13,17,30,0.6931147433280157,Dovish
폭설/NNG,14,19,33,0.6678595502512864,Dovish
떠난/VV,7,16,23,0.3965416079617013,Dovish
환경/NNG;안정/NNG,11,14,25,0.7121563571557085,Dovish
수명/NNG,15,20,35,0.6797856136486308,Dovish
통폐합/NNG,7,29,36,0.21878157680645588,Dovish
다중/NNG,6,14,20,0.3884489220849319,Dovish
출구/NNG,17,25,42,0.6163389563747586,Dovish
수출/NNG;모멘텀/NNG,11,18,29,0.5538993888988843,Dovish
대공황/NNG,25,36,61,0.6294311237487323,Dovish
전망/NNG;소폭/MAG;하향/NNG,11,14,25,0.7121563571557085,Dovish
외은/NNG,8,27,35,0.2685572794661258,Dovish
물가/NNG;상승률/NNG;확대/NNG,7,12,19,0.5287221439489351,Dovish
타인/NNG,10,17,27,0.5331651871753967,Dovish
물량/NNG;부담/NNG,42,65,107,0.5856614517588205,Dovish
사외이사/NNG,11,48,59,0.20771227083708163,Dovish
유동성/NNG;선호/NNG,6,11,17,0.49438953719900425,Dovish
크라카타우/NNG,14,21,35,0.6042538787987829,Dovish
대표기업/NNG,11,14,25,0.7121563571557085,Dovish
입점/NNG,3,14,17,0.19422446104246596,Dovish
물가/NNG;지표/NNG;상승/NNG,10,18,28,0.5035448989989859,Dovish
전망/NNG;낮/VV,10,17,27,0.5331651871753967,Dovish
사용료/NNG,8,15,23,0.4834031030390264,Dovish
경기/NNG;회복/NNG;둔화/NNG,11,16,27,0.6231368125112449,Dovish
세계/NNG;경제/NNG;완만/NNG;회복/NNG,12,15,27,0.7251046545585396,Dovish
방만/NNG,16,21,37,0.6905758614843234,Dovish
유례/NNG,8,18,26,0.40283591919918865,Dovish
분산투자/NNG,15,28,43,0.4855611526061649,Dovish
건설/NNG;부정적/VAX,10,14,24,0.6474148701415533,Dovish
기관차/NNG,7,22,29,0.28839389669941917,Dovish
pce/NNG;물가/NNG;상승/NNG,11,22,33,0.4531904090990872,Dovish
전망/NNG;경로/NNG;불확실성/NNG,14,24,38,0.5287221439489351,Dovish
첨부/NNG,17,38,55,0.4054861555097096,Dovish
국채/NNG;금리/NNG;오르/VV,78,99,177,0.7141182203985618,Dovish
주식시장/NNG,1036,1241,2277,0.7566563478270014,Dovish
신조/NNG,9,14,23,0.5826733831273979,Dovish
포항/NNG,5,13,18,0.34860800699929784,Dovish
공정가격/NNG,31,45,76,0.6243956747587424,Dovish
기가/NNG,9,11,20,0.7415843057985064,Dovish
경색/NNG,250,339,589,0.6684224322995387,Dovish
아무것/NNG,10,14,24,0.6474148701415533,Dovish
위임/NNG,5,18,23,0.25177244949949296,Dovish
손해배상/NNG,6,22,28,0.24719476859950212,Dovish
미화/NNG,4,14,18,0.2589659480566213,Dovish
틱스/NNG,43,55,98,0.7086250033185728,Dovish
투자심리/NNG;안정/NNG,11,14,25,0.7121563571557085,Dovish
지배주주/NNG,8,44,52,0.16479651239966808,Dovish
지지자/NNG,18,37,55,0.4409420196639768,Dovish
변동성/NNG;제한/NNG,38,49,87,0.7029075732965434,Dovish
미의회예산국/NNG,5,13,18,0.34860800699929784,Dovish
발견/NNG,80,104,184,0.6972160139985957,Dovish
높/VA;안정/NNG,2,17,19,0.10663303743507935,Dovish
데이/NNG,39,91,130,0.3884489220849319,Dovish
상환액/NNG,61,76,137,0.7274898672380085,Dovish
홀딩/NNG,9,30,39,0.27191424545945236,Dovish
파견/NNG,9,23,32,0.35467075494711175,Dovish
수익성/NNG;확보/NNG,11,14,25,0.7121563571557085,Dovish
가온/NNG,17,22,39,0.7003851776985893,Dovish
스테이션/NNG,7,12,19,0.5287221439489351,Dovish
신청/NNG,467,694,1161,0.6099133171448811,Dovish
취소/NNG,113,202,315,0.507034814140563,Dovish
정책위/NNG,11,22,33,0.4531904090990872,Dovish
컴퓨터/NNG,62,110,172,0.5108691884389711,Dovish
글로/NNG,15,18,33,0.7553173484984786,Dovish
급과/NNG,73,98,171,0.6751612217190484,Dovish
계감/NNG,7,10,17,0.6344665727387221,Dovish
요금/NNG;인상/NNG,8,12,20,0.604253878798783,Dovish
깔려/VV,22,31,53,0.6432380000116076,Dovish
단발/NNG,13,17,30,0.6931147433280157,Dovish
진입장벽/NNG,13,18,31,0.6546083686986816,Dovish
북문/NNG,13,27,40,0.43640557913245437,Dovish
보스/NNG,7,10,17,0.6344665727387221,Dovish
중위/NNG,26,32,58,0.7364344147860167,Dovish
투자계정/NNG,7,17,24,0.37321563102277766,Dovish
생물/NNG,15,20,35,0.6797856136486308,Dovish
종합계획/NNG,5,12,17,0.3776586742492394,Dovish
회채/NNG,11,26,37,0.3834688076992276,Dovish
화곡/NNG,8,17,25,0.4265321497403174,Dovish
연봉/NNG,24,60,84,0.3625523272792698,Dovish
장서/NNG,26,38,64,0.6201552966619088,Dovish
유동성/NNG;양호/NNG,7,10,17,0.6344665727387221,Dovish
구속력/NNG,8,12,20,0.604253878798783,Dovish
가이드라인/NNG,168,211,379,0.7216681396080252,Dovish
재무/NNG;지표/NNG;개선/NNG,10,12,22,0.7553173484984788,Dovish
슈트/NNG,6,17,23,0.319899112305238,Dovish
공직/NNG,9,14,23,0.5826733831273979,Dovish
인상/NNG;넘/VV,3,14,17,0.19422446104246596,Dovish
공급/NNG;감소/NNG,23,28,51,0.7445271006627863,Dovish
움직여야/VV,20,36,56,0.5035448989989859,Dovish
왕왕/MAG,1,23,24,0.039407861660790196,Dovish
이사장/NNG,15,46,61,0.29555896245592644,Dovish
해병대/NNG,12,16,28,0.6797856136486308,Dovish
은행/NNG;부담/NNG,8,15,23,0.4834031030390264,Dovish
재취업/NNG,8,10,18,0.7251046545585396,Dovish
응찰액/NNG,20,24,44,0.7553173484984788,Dovish
승수/NNG,104,135,239,0.698248926611927,Dovish
비로/NNG,6,12,18,0.4531904090990872,Dovish
예측가능성/NNG,20,40,60,0.45319040909908725,Dovish
코리아디스카운트/NNG,16,24,40,0.604253878798783,Dovish
마이너스금리/NNG,318,1398,1716,0.20617246079185939,Dovish
리가/NNG,88,105,193,0.7596334476327556,Dovish
신흥국/NNG;금리/NNG;인상/NNG,12,15,27,0.7251046545585396,Dovish
신년/NNG,8,13,21,0.5577728111988766,Dovish
일보/NNG,171,223,394,0.6950274435510665,Dovish
치웠/VV,1,24,25,0.03776586742492394,Dovish
투자/NNG;매력/NNG;감소/NNG,8,11,19,0.6591860495986723,Dovish
영원히/MAG,10,18,28,0.5035448989989859,Dovish
중심선/NNG,21,32,53,0.594812411942552,Dovish
산금채/NNG,227,341,568,0.603367876043946,Dovish
패닉/NNG,54,79,133,0.6195514453506509,Dovish
금리/NNG;인상/NNG;지연/NNG,26,32,58,0.7364344147860167,Dovish
재정/NNG;확대/NNG,46,56,102,0.7445271006627863,Dovish
로컬/NNG,46,73,119,0.5711440772207674,Dovish
로켓/NNG,11,18,29,0.5538993888988843,Dovish
짓눌렀/VV,7,12,19,0.5287221439489351,Dovish
지냈/VV,8,13,21,0.5577728111988766,Dovish
계금/NNG,8,17,25,0.4265321497403174,Dovish
법상/NNG,8,18,26,0.40283591919918865,Dovish
수출산업/NNG,11,15,26,0.6646792666786613,Dovish
포집/NNG,23,91,114,0.22908526174239574,Dovish
기술이전/NNG,7,14,21,0.45319040909908725,Dovish
과언/NNG,13,21,34,0.5610928874560127,Dovish
맞춰질/VV,13,22,35,0.5355886652989212,Dovish
동계/NNG,7,21,28,0.30212693939939145,Dovish
파편/NNG,8,14,22,0.5179318961132426,Dovish
경기/NNG;불황/NNG,7,14,21,0.45319040909908725,Dovish
크레딧/NNG;스프레드/NNG;축소/NNG,16,20,36,0.7251046545585396,Dovish
수요예측/NNG;흥행/NNG,32,51,83,0.5687095329870898,Dovish
결속력/NNG,8,13,21,0.5577728111988766,Dovish
운전자/NNG,14,17,31,0.7464312620455553,Dovish
그램/NNG,15,45,60,0.30212693939939145,Dovish
페이스/NNG,29,56,85,0.4693757808526261,Dovish
가방/NNG,4,24,28,0.15106346969969575,Dovish
사분면/NNG,14,18,32,0.7049628585985802,Dovish
크리스/NNG,20,30,50,0.604253878798783,Dovish
fed/NNG;통화정책/NNG;완화/NNG,11,22,33,0.4531904090990872,Dovish
재인/NNG,43,59,102,0.6605826302122288,Dovish
용일/NNG,26,65,91,0.3625523272792698,Dovish
임명/NNG,86,107,193,0.7284929940658225,Dovish
울리/VV,7,14,21,0.45319040909908725,Dovish
일반은행채/NNG,4,20,24,0.1812761636396349,Dovish
잔류/NNG,22,54,76,0.3692662592659229,Dovish
금리/NNG;변동성/NNG;낮/VA,7,10,17,0.6344665727387221,Dovish
따름/VV,10,13,23,0.6972160139985957,Dovish
신종/NNG,236,355,591,0.6025517551965328,Dovish
부도/NNG;위험/NNG,9,17,26,0.47984866845785706,Dovish
보조금/NNG,211,279,490,0.6854707979921677,Dovish
부진/NNG;하락/NNG,5,14,19,0.32370743507077665,Dovish
거촌/NNG,7,16,23,0.3965416079617013,Dovish
내수/NNG;활성화/NNG,8,11,19,0.6591860495986723,Dovish
톡톡/MAG,7,11,18,0.5767877933988383,Dovish
생산/NNG;중단/NNG,8,17,25,0.4265321497403174,Dovish
참여국/NNG,5,26,31,0.17430400349964892,Dovish
애저/NNG,8,13,21,0.5577728111988766,Dovish
요타/NNG,4,25,29,0.1450209309117079,Dovish
오르내리/VV,38,47,85,0.7328185338623537,Dovish
회사채/NNG;시장/NNG;안정/NNG,10,15,25,0.604253878798783,Dovish
국향/NNG,17,27,44,0.5706842188655172,Dovish
알렸/VV,15,21,36,0.6474148701415531,Dovish
내부통제/NNG,61,90,151,0.6143247767787626,Dovish
자율협약/NNG,26,36,62,0.6546083686986816,Dovish
글러/VA,4,14,18,0.2589659480566213,Dovish
활기/NNG,54,71,125,0.6893600589112877,Dovish
무제한/NNG;양적완화/NNG,9,13,22,0.6274944125987362,Dovish
금리/NNG;내리/VV;어렵/VA,16,26,42,0.5577728111988766,Dovish
준정부기관/NNG,7,24,31,0.26436107197446757,Dovish
미남/NNG,16,20,36,0.7251046545585396,Dovish
증세/NNG,53,77,130,0.6238725112273149,Dovish
디디/NNG,33,57,90,0.5247467894831537,Dovish
보수당/NNG,31,41,72,0.6853123259547172,Dovish
이전/NNG;금리/NNG;인하/NNG,14,19,33,0.6678595502512864,Dovish
금리/NNG;변동성/NNG;축소/NNG,15,18,33,0.7553173484984786,Dovish
갈아탈/VV,4,15,19,0.2417015515195132,Dovish
풍풍/MAG,8,23,31,0.31526289328632157,Dovish
한금/NNG,17,44,61,0.35019258884929466,Dovish
긴급대출/NNG,12,24,36,0.4531904090990872,Dovish
관망세/NNG,237,320,557,0.671288293478023,Dovish
신탁상품/NNG,5,16,21,0.28324400568692953,Dovish
투자자보호/NNG,18,44,62,0.3707921528992532,Dovish
바통/NNG,7,17,24,0.37321563102277766,Dovish
원내대표/NNG,29,36,65,0.7301401035485295,Dovish
대항/NNG,10,23,33,0.39407861660790194,Dovish
평가이익/NNG,32,49,81,0.591922166986563,Dovish
투자/NNG;급증/NNG,7,12,19,0.5287221439489351,Dovish
주택담보/NNG,20,26,46,0.6972160139985957,Dovish
영업부/NNG,28,45,73,0.5639702868788641,Dovish
줄임/VV,14,17,31,0.7464312620455553,Dovish
순공/NNG,8,16,24,0.4531904090990872,Dovish
기업지배구조/NNG,15,77,92,0.17656769185678722,Dovish
제자리걸음/NNG,11,40,51,0.24925472500449794,Dovish
소각/NNG,33,42,75,0.7121563571557085,Dovish
카르텔/NNG,8,12,20,0.604253878798783,Dovish
통화정책/NNG;민감/NNG;금리/NNG;상승/NNG,10,12,22,0.7553173484984788,Dovish
구매지수/NNG,4,13,17,0.2788864055994383,Dovish
채굴량/NNG,4,14,18,0.2589659480566213,Dovish
총격/NNG,2,23,25,0.07881572332158039,Dovish
지표/NNG;금리/NNG;하락/NNG,26,32,58,0.7364344147860167,Dovish
발권력/NNG,20,56,76,0.32370743507077665,Dovish
펀더멘털/NNG;양호/NNG,12,18,30,0.604253878798783,Dovish
금리/NNG;변동성/NNG;제한/NNG,9,12,21,0.6797856136486309,Dovish
개선/NNG;기대/NNG;높/VA,8,12,20,0.604253878798783,Dovish
당황/NNG,15,19,34,0.715563803840664,Dovish
피력/NNG,126,173,299,0.6601386305952023,Dovish
악영향/NNG,102,129,231,0.7166732050869286,Dovish
부채총계/NNG,21,40,61,0.4758499295540416,Dovish
행태/NNG,83,129,212,0.5831752551197557,Dovish
관리형토지신탁/NNG,6,15,21,0.3625523272792698,Dovish
리포/NNG,5,12,17,0.3776586742492394,Dovish
군대/NNG,6,11,17,0.49438953719900425,Dovish
일시적/VAX;하락/NNG,8,14,22,0.5179318961132426,Dovish
황사/NNG,7,12,19,0.5287221439489351,Dovish
파생금융상품/NNG,5,12,17,0.3776586742492394,Dovish
출하/NNG,77,95,172,0.7346455052764151,Dovish
선순환/NNG,93,164,257,0.513984244466038,Dovish
천정부지/NNG,10,15,25,0.604253878798783,Dovish
경제/NNG;어렵/VA,9,15,24,0.5438284909189047,Dovish
오퍼레이션트위스트/NNG,15,57,72,0.23852126794688797,Dovish
잠재/NNG;성장률/NNG;하락/NNG,15,27,42,0.5035448989989858,Dovish
포텐셜/NNG,8,18,26,0.40283591919918865,Dovish
공간/NNG,52,63,115,0.7481238499413503,Dovish
생산함수/NNG,8,30,38,0.2417015515195132,Dovish
대손/NNG;부담/NNG,8,10,18,0.7251046545585396,Dovish
강력/NNG;성장/NNG,9,13,22,0.6274944125987362,Dovish
통관/NNG,14,17,31,0.7464312620455553,Dovish
일희일비/NNG,24,35,59,0.621518275335891,Dovish
타협안/NNG,3,16,19,0.1699464034121577,Dovish
양육/NNG,3,14,17,0.19422446104246596,Dovish
경제/NNG;금리/NNG;인하/NNG,19,25,44,0.6888494218306125,Dovish
비서/NNG,30,40,70,0.6797856136486308,Dovish
기대/NNG;주가/NNG;상승/NNG,6,20,26,0.2719142454594523,Dovish
파생/NNG,65,81,146,0.7273426318874239,Dovish
물꼬/NNG,23,41,64,0.5084575321599516,Dovish
운운/NNG,124,162,286,0.6937729719541582,Dovish
카드사태/NNG,37,47,84,0.713533835602818,Dovish
지나간/VV,16,24,40,0.604253878798783,Dovish
디플레이션/NNG;물가/NNG;하락/NNG,4,13,17,0.2788864055994383,Dovish
준비자산/NNG,15,23,38,0.5911179249118529,Dovish
금리/NNG;인상/NNG;우려/NNG;완화/NNG,11,17,28,0.5864817058929364,Dovish
대통령실/NNG,112,159,271,0.6384569285421102,Dovish
포워드/NNG,114,145,259,0.7126028501695992,Dovish
드레싱/NNG,10,18,28,0.5035448989989859,Dovish
바이오산업/NNG,5,13,18,0.34860800699929784,Dovish
아마도/MAG,62,123,185,0.4568748839698115,Dovish
외압/NNG,6,11,17,0.49438953719900425,Dovish
태스크포스/NNG,7,10,17,0.6344665727387221,Dovish
재정/NNG;개선/NNG,17,25,42,0.6163389563747586,Dovish
cds/NNG;프리미엄/NNG;급등/NNG,8,12,20,0.604253878798783,Dovish
급전/NNG,18,22,40,0.7415843057985064,Dovish
야심/NNG,12,15,27,0.7251046545585396,Dovish
도마/NNG,7,16,23,0.3965416079617013,Dovish
수출/NNG;투자/NNG;부진/NNG,13,17,30,0.6931147433280157,Dovish
욕심/NNG,11,18,29,0.5538993888988843,Dovish
주택담보대출/NNG;금리/NNG;하락/NNG,7,16,23,0.3965416079617013,Dovish
구할/VV,11,16,27,0.6231368125112449,Dovish
화살/NNG,8,17,25,0.4265321497403174,Dovish
fed/NNG;통화정책/NNG;긴축/NNG,8,12,20,0.604253878798783,Dovish
원문/NNG,7,10,17,0.6344665727387221,Dovish
아침/NNG,34,46,80,0.6699336482334333,Dovish
궁극적/VAX,121,164,285,0.668732189036458,Dovish
부실여신/NNG,19,26,45,0.6623552132986659,Dovish
글쎄/NNG,10,13,23,0.6972160139985957,Dovish
꼬리/NNG,9,15,24,0.5438284909189047,Dovish
균형재정/NNG,20,51,71,0.3554434581169312,Dovish
총합/NNG,14,17,31,0.7464312620455553,Dovish
황원/NNG,228,275,503,0.7514720965424865,Dovish
테이퍼링/NNG;종료/NNG,8,11,19,0.6591860495986723,Dovish
월드컵/NNG,5,12,17,0.3776586742492394,Dovish
생활비/NNG,35,44,79,0.7209847417485479,Dovish
융자/NNG,220,320,540,0.6231368125112449,Dovish
자율적/VAX,24,43,67,0.5058869682966555,Dovish
중처/NNG,9,13,22,0.6274944125987362,Dovish
지켜야/VV,7,11,18,0.5767877933988383,Dovish
몰라도/VV,13,16,29,0.7364344147860167,Dovish
인하/NNG;추세/NNG,6,12,18,0.4531904090990872,Dovish
수순/NNG,96,115,211,0.7566309438871717,Dovish
부동산/NNG;우려/NNG,24,35,59,0.621518275335891,Dovish
언어/NNG,11,21,32,0.4747709047704723,Dovish
해해/NNG,40,79,119,0.4589269965560377,Dovish
수술/NNG,18,30,48,0.5438284909189047,Dovish
대피/NNG,12,25,37,0.4350627927351237,Dovish
회사채/NNG;스프레드/NNG;축소/NNG,27,45,72,0.5438284909189047,Dovish
주비/NNG,5,12,17,0.3776586742492394,Dovish
자동차세/NNG,1,20,21,0.04531904090990872,Dovish
공동관리/NNG,4,17,21,0.2132660748701587,Dovish
인상/NNG;카드/NNG;배제/NNG,6,12,18,0.4531904090990872,Dovish
멘탈/NNG,10,14,24,0.6474148701415533,Dovish
공기업/NNG,262,341,603,0.6963981653018232,Dovish
포문/NNG,6,13,19,0.4183296083991574,Dovish
계승/NNG,11,14,25,0.7121563571557085,Dovish
재간접/NNG,4,16,20,0.2265952045495436,Dovish
탐사/NNG,14,20,34,0.6344665727387221,Dovish
절상/NNG,398,687,1085,0.5250939820129162,Dovish
국수/NNG,14,19,33,0.6678595502512864,Dovish
희미/NNG,5,14,19,0.32370743507077665,Dovish
국민투표/NNG,49,118,167,0.37637847535347924,Dovish
분열/NNG,25,31,56,0.7309522727404633,Dovish
주식자금/NNG,79,102,181,0.702000829780939,Dovish
금융규제안/NNG,1,16,17,0.0566488011373859,Dovish
엄밀/NNG,5,17,22,0.26658259358769837,Dovish
a+등급/NNG,107,184,291,0.5270801497130688,Dovish
갖췄/VV,10,14,24,0.6474148701415533,Dovish
하향/NNG;압력/NNG,9,16,25,0.5098392102364732,Dovish
광광/MAG,14,30,44,0.42297771515914806,Dovish
푸른색/NNG,20,26,46,0.6972160139985957,Dovish
유로존/NNG;경기/NNG;회복/NNG,9,19,28,0.42933828230439847,Dovish
자전/NNG,8,11,19,0.6591860495986723,Dovish
전망/NNG;우려/NNG,8,14,22,0.5179318961132426,Dovish
공존/NNG,82,101,183,0.7358735355668347,Dovish
투자심리/NNG;부정적/VAX,5,18,23,0.25177244949949296,Dovish
참사/NNG,9,17,26,0.47984866845785706,Dovish
순상환세/NNG,11,21,32,0.4747709047704723,Dovish
차액/NNG,35,46,81,0.6896375790638284,Dovish
맞춰져/VV,12,18,30,0.604253878798783,Dovish
소비자/NNG;물가/NNG;상승률/NNG;물가/NNG;안정/NNG,15,28,43,0.4855611526061649,Dovish
제로금리정책/NNG,14,17,31,0.7464312620455553,Dovish
순유/NNG,12,19,31,0.5724510430725313,Dovish
열악/NNG,19,24,43,0.7175514810735547,Dovish
자본비용/NNG,15,35,50,0.38844892208493187,Dovish
증산/NNG,24,50,74,0.4350627927351237,Dovish
청사진/NNG,11,14,25,0.7121563571557085,Dovish
공기업민영화/NNG,3,18,21,0.15106346969969575,Dovish
크레딧/NNG;우호적/VAX,11,14,25,0.7121563571557085,Dovish
판매사/NNG,15,76,91,0.178890950960166,Dovish
미지급/NNG,43,54,97,0.721747688565213,Dovish
인연/NNG,7,11,18,0.5767877933988383,Dovish
면역/NNG,15,18,33,0.7553173484984786,Dovish
리밸런싱/NNG,22,42,64,0.4747709047704723,Dovish
흑인/NNG,32,41,73,0.707419175179063,Dovish
해외진출/NNG,18,22,40,0.7415843057985064,Dovish
채권/NNG;금리/NNG;바닥/NNG,13,19,32,0.6201552966619088,Dovish
듀레이션/NNG;축소/NNG,34,41,75,0.7516328736277544,Dovish
교양/NNG,7,10,17,0.6344665727387221,Dovish
질주/NNG,11,20,31,0.4985094500089959,Dovish
금기/NNG,10,13,23,0.6972160139985957,Dovish
유한회사/NNG,7,12,19,0.5287221439489351,Dovish
엘에스아이/NNG,19,35,54,0.4920353013075804,Dovish
재정/NNG;건전성/NNG;개선/NNG,10,12,22,0.7553173484984788,Dovish
금리/NNG;인상/NNG;제한/NNG,9,13,22,0.6274944125987362,Dovish
전망/NNG;금리/NNG;인하/NNG,54,87,141,0.5625811975023152,Dovish
한산/NNG,76,93,169,0.7406983030436695,Dovish
권리행사/NNG,6,11,17,0.49438953719900425,Dovish
루머/NNG,22,33,55,0.6042538787987829,Dovish
신용등급채권/NNG,17,22,39,0.7003851776985893,Dovish
반독점/NNG,14,25,39,0.5075732581909776,Dovish
과표/NNG,6,11,17,0.49438953719900425,Dovish
유동성/NNG;공급/NNG;확대/NNG,18,22,40,0.7415843057985064,Dovish
개선/NNG;없/VA,3,16,19,0.1699464034121577,Dovish
그림자금융/NNG,61,113,174,0.4892852204432623,Dovish
공식적/VAX,126,157,283,0.7274139050507642,Dovish
고도/NNG,24,35,59,0.621518275335891,Dovish
영화관/NNG,12,20,32,0.5438284909189046,Dovish
파생상품시장/NNG,12,15,27,0.7251046545585396,Dovish
다이/NNG,9,19,28,0.42933828230439847,Dovish
당정/NNG,9,16,25,0.5098392102364732,Dovish
전성시대/NNG,11,21,32,0.4747709047704723,Dovish
딜링/NNG,10,29,39,0.3125451097235084,Dovish
출국/NNG,24,30,54,0.7251046545585396,Dovish
입자/NNG,14,19,33,0.6678595502512864,Dovish
순천/NNG,11,20,31,0.4985094500089959,Dovish
빅딜/NNG,12,22,34,0.49438953719900425,Dovish
호건/NNG,1,16,17,0.0566488011373859,Dovish
생산/NNG;위축/NNG,8,10,18,0.7251046545585396,Dovish
가격/NNG;약세/NNG,15,23,38,0.5911179249118529,Dovish
관련주식/NNG,111,232,343,0.43365633974136797,Dovish
실직자/NNG,5,17,22,0.26658259358769837,Dovish
양보/NNG,16,27,43,0.5371145589322516,Dovish
우려/NNG;낮/VV,16,24,40,0.604253878798783,Dovish
공짜/NNG,8,25,33,0.2900418618234158,Dovish
부적격/NNG,5,17,22,0.26658259358769837,Dovish
평과/NNG,18,23,41,0.7093415098942235,Dovish
추출/NNG,18,39,57,0.41832960839915745,Dovish
사사/NNG,110,132,242,0.7553173484984788,Dovish
농업금융/NNG,9,14,23,0.5826733831273979,Dovish
요구수익률/NNG,19,26,45,0.6623552132986659,Dovish
낮/VA;하락/NNG,8,13,21,0.5577728111988766,Dovish
루국/NNG,6,11,17,0.49438953719900425,Dovish
상계관세/NNG,7,11,18,0.5767877933988383,Dovish
물가/NNG;하방/NNG;압력/NNG,21,32,53,0.594812411942552,Dovish
전망/NNG;경제/NNG;성장/NNG,10,15,25,0.604253878798783,Dovish
우려/NNG;강세/NNG,8,11,19,0.6591860495986723,Dovish
안간힘/NNG,13,17,30,0.6931147433280157,Dovish
부임/NNG,14,17,31,0.7464312620455553,Dovish
유동성함정/NNG,22,37,59,0.5389291351448604,Dovish
성능/NNG,14,34,48,0.37321563102277766,Dovish
재정보강/NNG,7,17,24,0.37321563102277766,Dovish
유가/NNG;약세/NNG,9,11,20,0.7415843057985064,Dovish
매입계획/NNG,44,59,103,0.6759450169613503,Dovish
제국/NNG,6,14,20,0.3884489220849319,Dovish
만기보유/NNG,45,54,99,0.7553173484984786,Dovish
당좌예금/NNG,34,81,115,0.3804561459103448,Dovish
자정/NNG,11,16,27,0.6231368125112449,Dovish
탈출/NNG,62,96,158,0.5853709450863209,Dovish
노동당/NNG,20,44,64,0.41199128099917026,Dovish
몰이/NNG,4,14,18,0.2589659480566213,Dovish
두텁/VA,10,12,22,0.7553173484984788,Dovish
금하/NNG,8,16,24,0.4531904090990872,Dovish
나서/NNG,7,10,17,0.6344665727387221,Dovish
바벨/NNG,69,128,197,0.48859590980995343,Dovish
상여금/NNG,9,21,30,0.3884489220849319,Dovish
금시장/NNG,41,53,94,0.7011625197382103,Dovish
한계점/NNG,40,52,92,0.6972160139985957,Dovish
습습/NNG,29,51,80,0.5153930142695502,Dovish
불안/NNG;증폭/NNG,8,12,20,0.604253878798783,Dovish
전문위원/NNG,29,45,74,0.5841120828388235,Dovish
긴축/NNG;강도/NNG;완화/NNG,9,26,35,0.3137472062993681,Dovish
입각/NNG,18,23,41,0.7093415098942235,Dovish
부쩍/MAG,7,13,20,0.48805120979901695,Dovish
하이/NNG,102,170,272,0.5438284909189046,Dovish
은행/NNG;대출/NNG;증가/NNG,13,18,31,0.6546083686986816,Dovish
글로벌/NNG;경기/NNG;개선/NNG,19,24,43,0.7175514810735547,Dovish
따져/VV,26,40,66,0.5891475318288134,Dovish
변함없이/MAG,8,14,22,0.5179318961132426,Dovish
되돌아보/VV,11,16,27,0.6231368125112449,Dovish
배상안/NNG,2,27,29,0.06713931986653145,Dovish
실적/NNG;실망/NNG,5,14,19,0.32370743507077665,Dovish
무더기/NNG,10,15,25,0.604253878798783,Dovish
법정관리/NNG,67,159,226,0.38193405546715525,Dovish
일선/NNG,12,19,31,0.5724510430725313,Dovish
주식비중/NNG,22,51,73,0.39098780392862426,Dovish
납입/NNG,136,193,329,0.6386932190412006,Dovish
추모/NNG,7,20,27,0.31723328636936104,Dovish
극명/NNG,10,28,38,0.32370743507077665,Dovish
다국적/NNG,10,13,23,0.6972160139985957,Dovish
가결/NNG,44,70,114,0.5697250857245667,Dovish
주주식/NNG,13,25,38,0.4713180254630507,Dovish
수첩/NNG,8,10,18,0.7251046545585396,Dovish
이포/NNG,7,11,18,0.5767877933988383,Dovish
상권/NNG,22,29,51,0.6875992413917185,Dovish
임금/NNG;오르/VV,12,15,27,0.7251046545585396,Dovish
본제/NNG,14,18,32,0.7049628585985802,Dovish
투자/NNG;위험/NNG,13,17,30,0.6931147433280157,Dovish
경기/NNG;불확실성/NNG;우려/NNG,7,10,17,0.6344665727387221,Dovish
연체율/NNG;급등/NNG,7,10,17,0.6344665727387221,Dovish
우려/NNG;안전자산/NNG;선호/NNG,14,18,32,0.7049628585985802,Dovish
인플레이션/NNG;상승/NNG;압력/NNG,15,20,35,0.6797856136486308,Dovish
사활/NNG,11,16,27,0.6231368125112449,Dovish
우호/NNG,9,17,26,0.47984866845785706,Dovish
가계/NNG;부채/NNG;우려/NNG,14,21,35,0.6042538787987829,Dovish
은행업/NNG,72,93,165,0.7017141818308448,Dovish
운동/NNG,116,174,290,0.604253878798783,Dovish
상동/NNG,42,59,101,0.6452202434631072,Dovish
회관/NNG,26,71,97,0.3319141024387681,Dovish
프레디맥/NNG,24,39,63,0.5577728111988766,Dovish
담보인정비율/NNG,7,11,18,0.5767877933988383,Dovish
슈어/NNG,25,33,58,0.6866521349986171,Dovish
아이오/NNG,6,25,31,0.21753139636756186,Dovish
혹시/MAG,20,31,51,0.5847618181923706,Dovish
총위험액/NNG,5,15,20,0.3021269393993915,Dovish
총량/NNG,77,130,207,0.5368563307789188,Dovish
둔감/NNG,7,22,29,0.28839389669941917,Dovish
쏟아진/VV,14,33,47,0.38452519559922554,Dovish
설계/NNG,104,126,230,0.7481238499413503,Dovish
두각/NNG,14,19,33,0.6678595502512864,Dovish
금리/NNG;전망/NNG;금리/NNG;인하/NNG,8,11,19,0.6591860495986723,Dovish
인창/NNG,8,16,24,0.4531904090990872,Dovish
내심/NNG,22,44,66,0.4531904090990872,Dovish
생략/NNG,43,56,99,0.6959709854021697,Dovish
기하/VV,33,45,78,0.6646792666786613,Dovish
입장차/NNG,10,16,26,0.5664880113738591,Dovish
실리콘/NNG,8,14,22,0.5179318961132426,Dovish
매매동향/NNG,79,118,197,0.6068142765903032,Dovish
급부상/NNG,22,27,49,0.7385325185318458,Dovish
회사채/NNG;신용스프레드/NNG;축소/NNG,11,17,28,0.5864817058929364,Dovish
저자/NNG,15,51,66,0.2665825935876983,Dovish
gdp/NNG;성장률/NNG;상향/NNG,8,12,20,0.604253878798783,Dovish
지표채권/NNG,11,22,33,0.4531904090990872,Dovish
변명/NNG,19,38,57,0.4531904090990872,Dovish
보복관세/NNG,32,40,72,0.7251046545585396,Dovish
본관/NNG,14,23,37,0.5517100632510628,Dovish
부양/NNG;효과/NNG,32,41,73,0.707419175179063,Dovish
통화/NNG;긴축/NNG;완화/NNG,8,12,20,0.604253878798783,Dovish
길이/NNG,8,20,28,0.3625523272792698,Dovish
많/VA;금리/NNG;인상/NNG,3,15,18,0.1812761636396349,Dovish
동남/NNG,8,18,26,0.40283591919918865,Dovish
협업/NNG,41,55,96,0.6756657008386391,Dovish
기대수익률/NNG,86,240,326,0.32478645985434584,Dovish
라이선스/NNG,18,24,42,0.6797856136486309,Dovish
전망/NNG;경기/NNG;침체/NNG,9,12,21,0.6797856136486309,Dovish
용목/NNG,8,21,29,0.3452879307421617,Dovish
주사/NNG,15,21,36,0.6474148701415531,Dovish
bei/NNG;상승/NNG,7,14,21,0.45319040909908725,Dovish
인플레이션/NNG;기대/NNG;낮/VV,8,12,20,0.604253878798783,Dovish
시가총액/NNG,355,504,859,0.6384229969451427,Dovish
롬바르드/NNG,7,10,17,0.6344665727387221,Dovish
상한다/VV,10,21,31,0.4316099134277021,Dovish
보유세/NNG,20,26,46,0.6972160139985957,Dovish
휴직/NNG,23,50,73,0.41693517637116023,Dovish
원국/NNG,7,17,24,0.37321563102277766,Dovish
출원/NNG,7,14,21,0.45319040909908725,Dovish
출로/NNG,13,17,30,0.6931147433280157,Dovish
보호무역/NNG,19,84,103,0.20501470887815848,Dovish
어조/NNG,15,21,36,0.6474148701415531,Dovish
연간화/NNG,17,24,41,0.6420197462237068,Dovish
안내문/NNG,5,19,24,0.23852126794688802,Dovish
대출시/NNG,8,21,29,0.3452879307421617,Dovish
하치/NNG,17,21,38,0.7337368528270936,Dovish
예대율/NNG,145,220,365,0.5973873574487968,Dovish
희비/NNG,26,38,64,0.6201552966619088,Dovish
지출/NNG;증가/NNG,28,40,68,0.6344665727387221,Dovish
하향/NNG;가능성/NNG;높/VA,7,10,17,0.6344665727387221,Dovish
피스/NNG,50,74,124,0.6124194717555232,Dovish
처방/NNG,16,34,50,0.4265321497403174,Dovish
금리/NNG;낙폭/NNG;축소/NNG,9,12,21,0.6797856136486309,Dovish
시장주체/NNG,59,100,159,0.5347646827369229,Dovish
심도/NNG,18,24,42,0.6797856136486309,Dovish
잠재수요/NNG,14,18,32,0.7049628585985802,Dovish
fed/NNG;금리/NNG;낮/VV,10,15,25,0.604253878798783,Dovish
하락/NNG;어렵/VA,10,12,22,0.7553173484984788,Dovish
기술개발/NNG,30,49,79,0.5549270315499026,Dovish
돋보였/VV,15,22,37,0.6179869214987552,Dovish
캘린더/NNG,47,72,119,0.5916652563238084,Dovish
남중/NNG,11,24,35,0.41542454167416326,Dovish
스피드/NNG,4,14,18,0.2589659480566213,Dovish
경보/NNG,17,26,43,0.5926336118988063,Dovish
금리/NNG;하락/NNG;제한적/VAX,17,21,38,0.7337368528270936,Dovish
갈아타/VV,60,133,193,0.40889360219466514,Dovish
생산자/NNG;물가/NNG;예상/NNG;웃돌/VV,6,14,20,0.3884489220849319,Dovish
고채/NNG,125,213,338,0.531913625703154,Dovish
인간/NNG,20,38,58,0.47704253589377604,Dovish
더뎌지/VA,12,20,32,0.5438284909189046,Dovish
워크숍/NNG,5,18,23,0.25177244949949296,Dovish
윤리/NNG,16,30,46,0.4834031030390264,Dovish
미/NNG;국채/NNG;금리/NNG;오르/VV,17,38,55,0.4054861555097096,Dovish
영업현금흐름/NNG,81,104,185,0.7059312141735781,Dovish
의복/NNG,7,18,25,0.3524814292992901,Dovish
진구/NNG,7,16,23,0.3965416079617013,Dovish
사직/NNG,24,29,53,0.7501082633364201,Dovish
대표지수/NNG,23,28,51,0.7445271006627863,Dovish
미결제/NNG,31,43,74,0.6534373340498467,Dovish
앞지르/VV,8,10,18,0.7251046545585396,Dovish
유동성/NNG;확충/NNG,7,11,18,0.5767877933988383,Dovish
국간/NNG,11,24,35,0.41542454167416326,Dovish
사뭇/MAG,23,34,57,0.6131399652517062,Dovish
경기/NNG;방어/NNG,15,20,35,0.6797856136486308,Dovish
정파/NNG,18,26,44,0.6274944125987362,Dovish
환경/NNG;불확실성/NNG,8,10,18,0.7251046545585396,Dovish
원당/NNG,4,13,17,0.2788864055994383,Dovish
앞세운/VV,9,14,23,0.5826733831273979,Dovish
신용스프레드/NNG;확대/NNG;축소/NNG,6,13,19,0.4183296083991574,Dovish
대장/NNG,14,34,48,0.37321563102277766,Dovish
배당주/NNG,4,50,54,0.07251046545585395,Dovish
합당/NNG,14,17,31,0.7464312620455553,Dovish
드라이빙/NNG,36,43,79,0.7588304524449833,Dovish
대행/NNG,21,47,68,0.40497866345024813,Dovish
골든/NNG,7,14,21,0.45319040909908725,Dovish
비교우위/NNG,14,20,34,0.6344665727387221,Dovish
아슬아슬/MAG,16,22,38,0.6591860495986723,Dovish
관리계획/NNG,11,14,25,0.7121563571557085,Dovish
계기/NNG,288,349,637,0.7479589559916168,Dovish
위례/NNG,12,27,39,0.40283591919918865,Dovish
분봉/NNG,83,105,188,0.7164724562899855,Dovish
순상/NNG,99,176,275,0.5098392102364732,Dovish
신흥시장/NNG,134,203,337,0.5983006386135733,Dovish
듀레이션/NNG;줄/VV,7,15,22,0.42297771515914806,Dovish
행은/NNG,24,30,54,0.7251046545585396,Dovish
대출/NNG;급증/NNG,8,10,18,0.7251046545585396,Dovish
혼돈/NNG,10,13,23,0.6972160139985957,Dovish
화제/NNG,11,17,28,0.5864817058929364,Dovish
불린다/VV,11,15,26,0.6646792666786613,Dovish
정말로/MAG,16,22,38,0.6591860495986723,Dovish
시스템/NNG;위험/NNG,37,52,89,0.644924812948701,Dovish
무력화/NNG,15,19,34,0.715563803840664,Dovish
효용/NNG,26,36,62,0.6546083686986816,Dovish
탑재/NNG,40,55,95,0.6591860495986724,Dovish
자금중개기능/NNG,9,17,26,0.47984866845785706,Dovish
베스트/NNG,113,221,334,0.4634435857755371,Dovish
기간스프레드/NNG,186,223,409,0.7559947631608092,Dovish
주소/NNG,9,11,20,0.7415843057985064,Dovish
순자본/NNG,4,18,22,0.20141795959959433,Dovish
파격적/VAX,17,37,54,0.4164452407937558,Dovish
네트/NNG,7,18,25,0.3524814292992901,Dovish
자산총계/NNG,32,45,77,0.6445374707187018,Dovish
선거인단/NNG,4,23,27,0.15763144664316078,Dovish
비관론/NNG,45,80,125,0.509839210236473,Dovish
구제/NNG,53,70,123,0.6862597623500464,Dovish
금리/NNG;인하/NNG;가능성/NNG;높/VV,6,13,19,0.4183296083991574,Dovish
국고채/NNG;확대/NNG,8,14,22,0.5179318961132426,Dovish
유로존/NNG;금리/NNG;인하/NNG,12,25,37,0.4350627927351237,Dovish
부를/VV,21,29,50,0.6563447304193677,Dovish
거침없/VA,11,14,25,0.7121563571557085,Dovish
비전통적/VAX,54,75,129,0.6525941891026856,Dovish
직매입/NNG,28,109,137,0.2328317698123751,Dovish
최고점/NNG,55,66,121,0.7553173484984788,Dovish
어찌/MAG,32,51,83,0.5687095329870898,Dovish
부채비율/NNG,754,924,1678,0.7396224425556532,Dovish
시뮬레이션/NNG,17,26,43,0.5926336118988063,Dovish
가려/VV,9,18,27,0.45319040909908725,Dovish
방미/NNG,7,11,18,0.5767877933988383,Dovish
벌일/VV,6,11,17,0.49438953719900425,Dovish
금리/NNG;상승/NNG;금리/NNG;인하/NNG,6,19,25,0.2862255215362656,Dovish
우파/NNG,46,60,106,0.6948919606186005,Dovish
마진콜/NNG,15,21,36,0.6474148701415531,Dovish
국민경제/NNG,20,28,48,0.6474148701415533,Dovish
민자/NNG,29,35,64,0.7510012493642018,Dovish
기동/NNG,8,24,32,0.3021269393993915,Dovish
본다면/VV,35,63,98,0.5035448989989858,Dovish
과일/NNG,57,70,127,0.7380529519613707,Dovish
fed/NNG;금리/NNG;인상/NNG;가능성/NNG;배제/NNG,10,14,24,0.6474148701415533,Dovish
시티즌/NNG,5,30,35,0.15106346969969575,Dovish
회계법인/NNG,17,25,42,0.6163389563747586,Dovish
정책/NNG;종료/NNG,36,109,145,0.29935513261591085,Dovish
펼치/VV,119,163,282,0.6617136034698329,Dovish
업종비중/NNG,5,20,25,0.22659520454954363,Dovish
벨트/NNG,14,32,46,0.3965416079617013,Dovish
유익/NNG,14,17,31,0.7464312620455553,Dovish
재무활동/NNG,7,18,25,0.3524814292992901,Dovish
차입/NNG;부담/NNG;확대/NNG,22,31,53,0.6432380000116076,Dovish
탈당/NNG,7,13,20,0.48805120979901695,Dovish
달러원/NNG;하단/NNG,8,14,22,0.5179318961132426,Dovish
상처/NNG,6,11,17,0.49438953719900425,Dovish
순연/NNG,6,11,17,0.49438953719900425,Dovish
고로/NNG,2,15,17,0.1208507757597566,Dovish
수출금융/NNG,9,13,22,0.6274944125987362,Dovish
세부안/NNG,4,14,18,0.2589659480566213,Dovish
크레딧/NNG;투자심리/NNG;회복/NNG,10,12,22,0.7553173484984788,Dovish
생산자/NNG;물가/NNG;상승/NNG,16,21,37,0.6905758614843234,Dovish
탈퇴/NNG,140,235,375,0.5399715512669976,Dovish
컨벤션/NNG,4,13,17,0.2788864055994383,Dovish
캐드/NNG,153,185,338,0.7496014334287605,Dovish
단채/NNG,7,14,21,0.45319040909908725,Dovish
장사/NNG,23,29,52,0.7188537523640693,Dovish
의현/NNG,15,37,52,0.36745168305331394,Dovish
디자인/NNG,25,31,56,0.7309522727404633,Dovish
브이/NNG,40,52,92,0.6972160139985957,Dovish
사나/NNG,9,13,22,0.6274944125987362,Dovish
통화신용정책보고서/NNG,33,62,95,0.48242850000870574,Dovish
이마/NNG,11,17,28,0.5864817058929364,Dovish
고용/NNG;지표/NNG;개선/NNG,21,28,49,0.6797856136486309,Dovish
총체/NNG,12,19,31,0.5724510430725313,Dovish
핵전쟁/NNG,1,22,23,0.04119912809991702,Dovish
매출/NNG;증가/NNG,44,55,99,0.7251046545585396,Dovish
난주/NNG,16,28,44,0.5179318961132426,Dovish
완연/NNG,28,58,86,0.43756315361291176,Dovish
길라잡이/NNG,16,25,41,0.5800837236468316,Dovish
사자/NNG,103,184,287,0.5073762188826737,Dovish
유동성/NNG;부담/NNG,12,19,31,0.5724510430725313,Dovish
물가/NNG;쉽/VA,9,13,22,0.6274944125987362,Dovish
고용/NNG;상승/NNG,8,11,19,0.6591860495986723,Dovish
타자/NNG,9,13,22,0.6274944125987362,Dovish
일반화/NNG,7,12,19,0.5287221439489351,Dovish
국본/NNG,7,13,20,0.48805120979901695,Dovish
들들/MAG,9,18,27,0.45319040909908725,Dovish
한중/NNG,8,18,26,0.40283591919918865,Dovish
청구권/NNG,11,46,57,0.21674323913434604,Dovish
코피/NNG,8,10,18,0.7251046545585396,Dovish
자금조달계획/NNG,16,23,39,0.6305257865726431,Dovish
금리/NNG;양적완화/NNG,7,10,17,0.6344665727387221,Dovish
재해/NNG,30,40,70,0.6797856136486308,Dovish
외평/NNG,16,21,37,0.6905758614843234,Dovish
체법/NNG,8,18,26,0.40283591919918865,Dovish
장학/NNG,23,34,57,0.6131399652517062,Dovish
입찰일/NNG,15,19,34,0.715563803840664,Dovish
채권추심/NNG,8,26,34,0.2788864055994383,Dovish
특수은행채/NNG,37,57,94,0.588352460935657,Dovish
다수당/NNG,19,23,42,0.7487493715550136,Dovish
금리/NNG;인하/NNG;기대/NNG;강하/VA,8,11,19,0.6591860495986723,Dovish
퍼진/VV,8,11,19,0.6591860495986723,Dovish
하방/NNG;경직/NNG;강화/NNG,11,14,25,0.7121563571557085,Dovish
소식/NNG,1115,1351,2466,0.7480493059148516,Dovish
지식/NNG,21,58,79,0.32817236520968385,Dovish
상환권/NNG,9,18,27,0.45319040909908725,Dovish
반군/NNG,22,30,52,0.6646792666786613,Dovish
기일/NNG,24,37,61,0.5879226928853023,Dovish
시작점/NNG,11,14,25,0.7121563571557085,Dovish
브렉시트/NNG;불확실성/NNG,10,15,25,0.604253878798783,Dovish
전사/NNG,25,34,59,0.666456483969246,Dovish
가령/MAG,90,119,209,0.6854980977969386,Dovish
크레딧/NNG;시장/NNG;불안/NNG,12,16,28,0.6797856136486308,Dovish
무역/NNG;분쟁/NNG;우려/NNG,7,14,21,0.45319040909908725,Dovish
획획/MAG,35,73,108,0.43456614571145347,Dovish
자산/NNG;부실/NNG,9,11,20,0.7415843057985064,Dovish
패소/NNG,7,13,20,0.48805120979901695,Dovish
실무자/NNG,8,14,22,0.5179318961132426,Dovish
매입자산/NNG,15,20,35,0.6797856136486308,Dovish
후술/NNG,8,13,21,0.5577728111988766,Dovish
정화/NNG,12,17,29,0.639798224610476,Dovish
앞당긴/VV,4,14,18,0.2589659480566213,Dovish
진짜/NNG,5,12,17,0.3776586742492394,Dovish
상당수/NNG,95,117,212,0.7359502369985177,Dovish
결정시점/NNG,6,12,18,0.4531904090990872,Dovish
핑핑/MAG,15,49,64,0.2774635157749513,Dovish
석유공사/NNG,30,52,82,0.5229120104989468,Dovish
매입/NNG,3762,4842,8604,0.704214092949511,Dovish
신도/NNG,2,15,17,0.1208507757597566,Dovish
인하/NNG;가능성/NNG;낮/VA,9,12,21,0.6797856136486309,Dovish
감리/NNG,14,23,37,0.5517100632510628,Dovish
변동성/NNG;감소/NNG,8,13,21,0.5577728111988766,Dovish
발송/NNG,10,15,25,0.604253878798783,Dovish
가격/NNG;낮/VA,18,29,47,0.5625811975023152,Dovish
매입량/NNG,6,30,36,0.1812761636396349,Dovish
둔다/VV,19,32,51,0.5381636108051661,Dovish
전미주택건설업협회/NNG,10,13,23,0.6972160139985957,Dovish
성급/NNG;금리/NNG;인하/NNG,7,10,17,0.6344665727387221,Dovish
나이스/NNG,33,43,76,0.6955945814079014,Dovish
극단적/VAX,100,166,266,0.5460125410832377,Dovish
국채/NNG;매입/NNG;축소/NNG,28,41,69,0.6189917782816802,Dovish
수업/NNG,22,33,55,0.6042538787987829,Dovish
대출/NNG;둔화/NNG,9,12,21,0.6797856136486309,Dovish
공시가격/NNG,26,80,106,0.2945737659144067,Dovish
금리/NNG;인하/NNG;논의/NNG;없/VA,8,16,24,0.4531904090990872,Dovish
도철/NNG,2,15,17,0.1208507757597566,Dovish
무르익/VV,14,24,38,0.5287221439489351,Dovish
떠나/VV,66,80,146,0.747764175013494,Dovish
출금/NNG,9,11,20,0.7415843057985064,Dovish
안정/NNG;하락/NNG,16,20,36,0.7251046545585396,Dovish
정계/NNG,7,10,17,0.6344665727387221,Dovish
미수금/NNG,34,53,87,0.5814518456365647,Dovish
조항/NNG,95,118,213,0.729713370583276,Dovish
복지부/NNG,8,10,18,0.7251046545585396,Dovish
지탱/NNG,54,65,119,0.7529932951184835,Dovish
갑작/MAG,49,67,116,0.6628755237568739,Dovish
강강한/VA,9,18,27,0.45319040909908725,Dovish
주인/NNG,71,108,179,0.5958614638154665,Dovish
유전/NNG,10,20,30,0.45319040909908725,Dovish
수요/NNG;크/VV,6,11,17,0.49438953719900425,Dovish
금융상품/NNG,129,155,284,0.7543427454681582,Dovish
금리/NNG;상승/NNG;반납/NNG,12,15,27,0.7251046545585396,Dovish
사철/NNG,3,14,17,0.19422446104246596,Dovish
응찰금액/NNG,23,28,51,0.7445271006627863,Dovish
신우/NNG,9,12,21,0.6797856136486309,Dovish
매칭/NNG,41,67,108,0.5546509484496291,Dovish
개별업종/NNG,3,29,32,0.09376353291705251,Dovish
투자심리/NNG;훼손/NNG,8,15,23,0.4834031030390264,Dovish
사만/NNG,19,25,44,0.6888494218306125,Dovish
텃밭/NNG,5,16,21,0.28324400568692953,Dovish
프랑/NNG,122,175,297,0.631876913258156,Dovish
패시브/NNG,18,43,61,0.37941522622249163,Dovish
불능/NNG,13,21,34,0.5610928874560127,Dovish
무보증사채/NNG,56,81,137,0.6266336520876268,Dovish
결제수요/NNG,87,121,208,0.6516952990350511,Dovish
우측/NNG,48,65,113,0.6693273734386519,Dovish
금리/NNG;하락/NNG;금리/NNG;인하/NNG,10,15,25,0.604253878798783,Dovish
취약점/NNG,15,26,41,0.5229120104989468,Dovish
스캔들/NNG,29,66,95,0.39825823829919793,Dovish
살짝/MAG,68,86,154,0.7166732050869286,Dovish
초과수익/NNG,104,141,245,0.6685362063305684,Dovish
대비책/NNG,14,18,32,0.7049628585985802,Dovish
테러/NNG,72,146,218,0.4469823213032093,Dovish
오버나이트/NNG,46,61,107,0.6835002891330496,Dovish
풀타임/NNG,11,22,33,0.4531904090990872,Dovish
막말/NNG,8,19,27,0.38163402871502083,Dovish
학자/NNG,20,24,44,0.7553173484984788,Dovish
금값/NNG,151,267,418,0.5125973915652597,Dovish
선진시장/NNG,36,53,89,0.615654895379892,Dovish
적당히/MAG,9,16,25,0.5098392102364732,Dovish
용역/NNG,18,35,53,0.4661387065019183,Dovish
아문/VV,7,12,19,0.5287221439489351,Dovish
보증비율/NNG,8,13,21,0.5577728111988766,Dovish
자율주행/NNG,41,56,97,0.663600241895092,Dovish
불러일으켰/VV,11,22,33,0.4531904090990872,Dovish
브렉시트/NNG,263,707,970,0.3371685363311455,Dovish
생산물/NNG,22,29,51,0.6875992413917185,Dovish
애플/NNG,11,19,30,0.5247467894831536,Dovish
소고/NNG,7,15,22,0.42297771515914806,Dovish
금리/NNG;물가/NNG;안정/NNG,8,14,22,0.5179318961132426,Dovish
정책수단/NNG,58,143,201,0.3676229891992596,Dovish
비관론자/NNG,9,19,28,0.42933828230439847,Dovish
지구공학/NNG,24,32,56,0.6797856136486308,Dovish
낙수효과/NNG,19,38,57,0.4531904090990872,Dovish
가중치/NNG,108,151,259,0.6482723732808136,Dovish
색색/MAG,9,26,35,0.3137472062993681,Dovish
감속/NNG,103,199,302,0.46913178027342695,Dovish
배기가스/NNG,8,11,19,0.6591860495986723,Dovish
위험/NNG;회피/NNG;확산/NNG,16,23,39,0.6305257865726431,Dovish
무역결제/NNG,10,15,25,0.604253878798783,Dovish
급매물/NNG,13,20,33,0.5891475318288134,Dovish
채무증권/NNG,16,27,43,0.5371145589322516,Dovish
변동성/NNG;축소/NNG,30,39,69,0.6972160139985956,Dovish
조속/NNG,23,28,51,0.7445271006627863,Dovish
일시적/VAX;확대/NNG,6,11,17,0.49438953719900425,Dovish
긍정적/VAX;모멘텀/NNG,5,12,17,0.3776586742492394,Dovish
마이너스금리/NNG;확대/NNG,2,17,19,0.10663303743507935,Dovish
자구계획/NNG,59,92,151,0.5812659594966554,Dovish
전함/VV,13,16,29,0.7364344147860167,Dovish
연례/NNG,52,83,135,0.5678530427265671,Dovish
지표/NNG;예상/NNG;높/VA,20,30,50,0.604253878798783,Dovish
대통령탄핵안/NNG,7,10,17,0.6344665727387221,Dovish
기초산업/NNG,7,12,19,0.5287221439489351,Dovish
박사/NNG,19,30,49,0.5740411848588438,Dovish
수익자/NNG,6,29,35,0.18752706583410503,Dovish
수요처/NNG,19,24,43,0.7175514810735547,Dovish
전망/NNG;신용등급/NNG;상향/NNG,6,11,17,0.49438953719900425,Dovish
적정의견/NNG,5,16,21,0.28324400568692953,Dovish
한겨레/NNG,31,37,68,0.7594001449768488,Dovish
쪼개/VV,7,16,23,0.3965416079617013,Dovish
디플레이션/NNG;위험/NNG,11,21,32,0.4747709047704723,Dovish
시한/NNG,89,129,218,0.6253325024778102,Dovish
글로벌/NNG;인플레이션/NNG;압력/NNG,11,16,27,0.6231368125112449,Dovish
치러/VV,13,18,31,0.6546083686986816,Dovish
금리/NNG;하락/NNG;상승/NNG,11,15,26,0.6646792666786613,Dovish
기업/NNG;임금/NNG;인상/NNG,5,18,23,0.25177244949949296,Dovish
리프트/NNG,7,15,22,0.42297771515914806,Dovish
금리/NNG;상승/NNG;과도/NNG,6,11,17,0.49438953719900425,Dovish
회사채/NNG;시장/NNG;강세/NNG,7,13,20,0.48805120979901695,Dovish
방화벽/NNG,4,16,20,0.2265952045495436,Dovish
금리/NNG;소폭/MAG;상승/NNG,75,92,167,0.7388974061398161,Dovish
국자/NNG,6,15,21,0.3625523272792698,Dovish
성동/NNG,13,23,36,0.5123022015902725,Dovish
앞뒤/NNG,6,13,19,0.4183296083991574,Dovish
관방/NNG,11,15,26,0.6646792666786613,Dovish
하이퍼인플레이션/NNG,16,28,44,0.5179318961132426,Dovish
금리/NNG;인상/NNG;가능성/NNG;높/VA,29,41,70,0.6410986275060259,Dovish
els/NNG,342,453,795,0.6842875051297477,Dovish
업스트림/NNG,4,13,17,0.2788864055994383,Dovish
발행주체/NNG,116,162,278,0.6490134253764707,Dovish
매개/NNG,20,30,50,0.604253878798783,Dovish
금리/NNG;오르/VV;금리/NNG;오르/VV,13,28,41,0.42081966559200956,Dovish
통제력/NNG,13,29,42,0.40630864264056094,Dovish
어렵/VA;우려/NNG,9,12,21,0.6797856136486309,Dovish
공평/NNG,10,17,27,0.5331651871753967,Dovish
에코/NNG,38,80,118,0.43053088864413286,Dovish
인하/NNG;금리/NNG;인하/NNG,8,17,25,0.4265321497403174,Dovish
뚜껑/NNG,8,12,20,0.604253878798783,Dovish
뜻한다/VV,41,53,94,0.7011625197382103,Dovish
읽힌다/VV,10,19,29,0.47704253589377604,Dovish
업자/NNG,48,77,125,0.5650166139417191,Dovish
신용스프레드/NNG;강세/NNG,39,55,94,0.6427063983587056,Dovish
예상/NNG;fed/NNG;금리/NNG;인하/NNG,7,12,19,0.5287221439489351,Dovish
경수/NNG,10,16,26,0.5664880113738591,Dovish
관장/NNG,4,21,25,0.17264396537108084,Dovish
인물/NNG,85,107,192,0.7200221452976152,Dovish
실증/NNG,11,36,47,0.2769496944494422,Dovish
우연/NNG,6,12,18,0.4531904090990872,Dovish
달러원/NNG;상방/NNG,20,25,45,0.7251046545585396,Dovish
트러스/NNG,10,13,23,0.6972160139985957,Dovish
지하철/NNG,17,27,44,0.5706842188655172,Dovish
채권금액/NNG,12,20,32,0.5438284909189046,Dovish
모기업/NNG,28,56,84,0.45319040909908725,Dovish
준이/NNG,25,41,66,0.552671230608643,Dovish
인상/NNG;그치/VV,8,11,19,0.6591860495986723,Dovish
경제/NNG;피해/NNG,5,14,19,0.32370743507077665,Dovish
성일/NNG,13,18,31,0.6546083686986816,Dovish
스플릿/NNG,45,63,108,0.6474148701415531,Dovish
각사/NNG,31,57,88,0.4929439537569018,Dovish
천선/NNG,5,13,18,0.34860800699929784,Dovish
들어갔/VV,45,68,113,0.5998108355723213,Dovish
인플레이션/NNG;압력/NNG;크/VV,8,14,22,0.5179318961132426,Dovish
무방/NNG,16,21,37,0.6905758614843234,Dovish
수년/NNG,80,98,178,0.7399027087332037,Dovish
결여/NNG,5,12,17,0.3776586742492394,Dovish
분면/NNG,7,17,24,0.37321563102277766,Dovish
만기구간/NNG,37,47,84,0.713533835602818,Dovish
카타/NNG,1,21,22,0.04316099134277021,Dovish
구간별/NNG,135,190,325,0.6440074234565976,Dovish
털털/MAG,5,19,24,0.23852126794688802,Dovish
상확/NNG,17,35,52,0.44024211169625616,Dovish
일대일로/NNG,10,20,30,0.45319040909908725,Dovish
단기/NNG;불확실성/NNG,9,12,21,0.6797856136486309,Dovish
구상/NNG,39,48,87,0.7364344147860168,Dovish
시민/NNG,66,93,159,0.6432380000116077,Dovish
회계/NNG,160,235,395,0.6171103443051401,Dovish
채권투자/NNG;심리/NNG;위축/NNG,6,15,21,0.3625523272792698,Dovish
어쨌든/MAG,11,19,30,0.5247467894831536,Dovish
예상/NNG;약하/VA,13,27,40,0.43640557913245437,Dovish
프라이머리/NNG,15,28,43,0.4855611526061649,Dovish
비트코인/NNG,756,1531,2287,0.4475662302794382,Dovish
만성/NNG,40,49,89,0.7399027087332037,Dovish
시리/NNG,55,66,121,0.7553173484984788,Dovish
명절/NNG,21,37,58,0.5144323562746396,Dovish
복수/NNG,38,60,98,0.5740411848588438,Dovish
황제/NNG,12,20,32,0.5438284909189046,Dovish
폐지/NNG,312,392,704,0.7214051410148735,Dovish
opec/NNG;산유국/NNG;감산/NNG,6,11,17,0.49438953719900425,Dovish
짓누르/VV,10,14,24,0.6474148701415533,Dovish
협상안/NNG,18,28,46,0.5826733831273979,Dovish
조세/NNG,54,89,143,0.5499389234011396,Dovish
특별자산/NNG,6,17,23,0.319899112305238,Dovish
뱅뱅뱅뱅/MAG,5,14,19,0.32370743507077665,Dovish
개혁안/NNG,50,133,183,0.34074466849555435,Dovish
용량/NNG,39,52,91,0.6797856136486308,Dovish
설비투자지수/NNG,9,14,23,0.5826733831273979,Dovish
가계/NNG;대출/NNG;억제/NNG,11,14,25,0.7121563571557085,Dovish
환경/NNG;긍정적/VAX,9,16,25,0.5098392102364732,Dovish
단일화/NNG,5,14,19,0.32370743507077665,Dovish
그친다/VV,21,27,48,0.7049628585985801,Dovish
환수/NNG,38,49,87,0.7029075732965434,Dovish
권면/NNG,7,10,17,0.6344665727387221,Dovish
제공업체/NNG,11,14,25,0.7121563571557085,Dovish
채널/NNG,87,119,206,0.6626481612037074,Dovish
금융투자업계/NNG,78,96,174,0.7364344147860168,Dovish
전미/NNG,44,75,119,0.531743413342929,Dovish
국기/NNG,14,22,36,0.5767877933988383,Dovish
협력업체/NNG,10,16,26,0.5664880113738591,Dovish
장단/NNG,12,17,29,0.639798224610476,Dovish
쇼트/NNG,8,13,21,0.5577728111988766,Dovish
발행/NNG;어렵/VA,6,13,19,0.4183296083991574,Dovish
파트너/NNG,58,72,130,0.7301401035485295,Dovish
식료/NNG,20,28,48,0.6474148701415533,Dovish
임계/NNG,54,70,124,0.6992080597528775,Dovish
밀착/NNG,7,20,27,0.31723328636936104,Dovish
보유자/NNG,52,81,133,0.5818741055099391,Dovish
불문/NNG,8,12,20,0.604253878798783,Dovish
금리/NNG;상승/NNG;억제/NNG,11,15,26,0.6646792666786613,Dovish
인공/NNG,9,11,20,0.7415843057985064,Dovish
재미/NNG,10,19,29,0.47704253589377604,Dovish
고용/NNG;늘/VV,20,28,48,0.6474148701415533,Dovish
crs/NNG;금리/NNG;상승/NNG,9,12,21,0.6797856136486309,Dovish
실질가치/NNG,9,14,23,0.5826733831273979,Dovish
ois금리/NNG,6,13,19,0.4183296083991574,Dovish
신신/NNG,355,596,951,0.5398744806381743,Dovish
돈/NNG;풀/VV,10,20,30,0.45319040909908725,Dovish
어가/NNG,10,16,26,0.5664880113738591,Dovish
비판/NNG,159,237,396,0.6080782704367499,Dovish
연맹/NNG,10,19,29,0.47704253589377604,Dovish
채권시장/NNG;금리/NNG;인하/NNG,35,66,101,0.4806564944990319,Dovish
획득/NNG,76,93,169,0.7406983030436695,Dovish
재정위험국/NNG,23,60,83,0.34744598030930024,Dovish
신용스프레드/NNG;저점/NNG,9,18,27,0.45319040909908725,Dovish
난방유/NNG,4,19,23,0.19081701435751042,Dovish
보우/NNG,66,104,170,0.5752032115488415,Dovish
계속기업/NNG,12,17,29,0.639798224610476,Dovish
종종/MAG,105,136,241,0.6997793081677082,Dovish
인순/NNG,13,31,44,0.3800951818250409,Dovish
투자/NNG;수요/NNG;증가/NNG,14,28,42,0.45319040909908725,Dovish
이견/NNG,129,155,284,0.7543427454681582,Dovish
환기/NNG,19,25,44,0.6888494218306125,Dovish
샤리아/NNG,1,67,68,0.01352807191340559,Dovish
동참/NNG,104,145,249,0.6500938282248975,Dovish
부실기업/NNG,25,46,71,0.49259827075987744,Dovish
개인파산/NNG,9,12,21,0.6797856136486309,Dovish
러셀/NNG,24,40,64,0.5438284909189046,Dovish
pce/NNG;물가/NNG;오르/VV,6,13,19,0.4183296083991574,Dovish
낮/VA;안정/NNG,11,14,25,0.7121563571557085,Dovish
끈다/VV,33,51,84,0.5864817058929365,Dovish
단기/NNG;금리/NNG;하락/NNG,29,43,72,0.6112800866917921,Dovish
연구/NNG,262,348,610,0.68239015622966,Dovish
경제/NNG;상승/NNG,10,19,29,0.47704253589377604,Dovish
경제/NNG;지표/NNG;견조/NNG,19,24,43,0.7175514810735547,Dovish
경제/NNG;좋/VA,20,36,56,0.5035448989989859,Dovish
조위/NNG,13,17,30,0.6931147433280157,Dovish
모양/NNG,25,30,55,0.7553173484984788,Dovish
국경조정세/NNG,2,40,42,0.04531904090990872,Dovish
인도량/NNG,21,28,49,0.6797856136486309,Dovish
위험/NNG;회피/NNG;성향/NNG;강화/NNG,8,10,18,0.7251046545585396,Dovish
탈이/NNG,10,23,33,0.39407861660790194,Dovish
마이너스증가율/NNG,7,14,21,0.45319040909908725,Dovish
워드/NNG,5,14,19,0.32370743507077665,Dovish
번지/VV,29,45,74,0.5841120828388235,Dovish
방치/NNG,14,34,48,0.37321563102277766,Dovish
상승률/NNG;상회/NNG,9,11,20,0.7415843057985064,Dovish
노동시장/NNG;약화/NNG,7,12,19,0.5287221439489351,Dovish
만났/VV,18,30,48,0.5438284909189047,Dovish
핑크/NNG,13,19,32,0.6201552966619088,Dovish
도산/NNG,38,47,85,0.7328185338623537,Dovish
재작년/NNG,19,29,48,0.5938357084746659,Dovish
우려/NNG;강화/NNG,11,14,25,0.7121563571557085,Dovish
부진/NNG;이어지/VV;성장/NNG,10,13,23,0.6972160139985957,Dovish
여가/NNG,13,19,32,0.6201552966619088,Dovish
하락/NNG;없/VA,9,13,22,0.6274944125987362,Dovish
회사채/NNG;발행/NNG;어렵/VA,5,12,17,0.3776586742492394,Dovish
꼬임/NNG,7,13,20,0.48805120979901695,Dovish
장기물/NNG;상승/NNG,7,12,19,0.5287221439489351,Dovish
실감/NNG,7,11,18,0.5767877933988383,Dovish
행과/NNG,10,15,25,0.604253878798783,Dovish
가성비/NNG,7,11,18,0.5767877933988383,Dovish
계약서/NNG,16,20,36,0.7251046545585396,Dovish
종종종/MAG,228,445,673,0.4643928686498512,Dovish
합리/NNG,37,45,82,0.7452464505184989,Dovish
검증/NNG,81,125,206,0.587334770192417,Dovish
가져가/VV,98,118,216,0.7527569507069585,Dovish
신상품/NNG,7,11,18,0.5767877933988383,Dovish
경기/NNG;안정/NNG,17,21,38,0.7337368528270936,Dovish
네고/NNG,202,257,459,0.7124082695565418,Dovish
채권시장/NNG;금리/NNG;하락/NNG,11,23,34,0.4334864782686921,Dovish
외화증권투자/NNG,5,26,31,0.17430400349964892,Dovish
캠코/NNG,61,77,138,0.7180419468842681,Dovish
강건/NNG,20,28,48,0.6474148701415533,Dovish
순순/NNG,159,330,489,0.4367107578591204,Dovish
가계/NNG;부채/NNG;위험/NNG,12,17,29,0.639798224610476,Dovish
결단/NNG,15,36,51,0.3776586742492393,Dovish
우상/NNG,44,61,105,0.6537828852576996,Dovish
과도/NNG;인하/NNG,10,12,22,0.7553173484984788,Dovish
위험자산/NNG;선호/NNG;강화/NNG,7,17,24,0.37321563102277766,Dovish
곡선/NNG,145,229,374,0.573909251697534,Dovish
물가/NNG;상승/NNG;임금/NNG;상승/NNG,8,18,26,0.40283591919918865,Dovish
드라마틱/NNG,9,18,27,0.45319040909908725,Dovish
내리막길/NNG,44,63,107,0.6330278730272964,Dovish
인플레이션/NNG;급등/NNG,15,23,38,0.5911179249118529,Dovish
양양/NNG,24,43,67,0.5058869682966555,Dovish
최장기간/NNG,13,17,30,0.6931147433280157,Dovish
전세시장/NNG,12,19,31,0.5724510430725313,Dovish
구원/NNG,14,18,32,0.7049628585985802,Dovish
대부업/NNG,21,43,64,0.4426510972595736,Dovish
주택구입자금/NNG,10,15,25,0.604253878798783,Dovish
가변/NNG,22,34,56,0.5864817058929364,Dovish
끝자락/NNG,9,11,20,0.7415843057985064,Dovish
합의/NNG,530,725,1255,0.6625956326138378,Dovish
바뀜/VV,9,14,23,0.5826733831273979,Dovish
판다/VV,4,14,18,0.2589659480566213,Dovish
명령/NNG,48,68,116,0.639798224610476,Dovish
레이팅/NNG,13,20,33,0.5891475318288134,Dovish
허브/NNG,30,69,99,0.3940786166079019,Dovish
쇄도/NNG,6,11,17,0.49438953719900425,Dovish
법규/NNG,9,23,32,0.35467075494711175,Dovish
꼬집/VV,16,31,47,0.46780945455389644,Dovish
돋보이/VV,15,32,47,0.42486600853039425,Dovish
자금/NNG;많/VA,8,11,19,0.6591860495986723,Dovish
분할상환/NNG,32,52,84,0.5577728111988766,Dovish
경상거래/NNG,7,10,17,0.6344665727387221,Dovish
종신보험/NNG,11,19,30,0.5247467894831536,Dovish
위안화채권/NNG,13,20,33,0.5891475318288134,Dovish
재정승수/NNG,15,18,33,0.7553173484984786,Dovish
특수은행/NNG,170,280,450,0.5503026396203202,Dovish
만기물별/NNG,14,19,33,0.6678595502512864,Dovish
채권/NNG;금리/NNG;인하/NNG,13,23,36,0.5123022015902725,Dovish
학생/NNG,35,47,82,0.6749644390837469,Dovish
교착/NNG,14,29,43,0.43756315361291176,Dovish
후보군/NNG,13,17,30,0.6931147433280157,Dovish
공로/NNG,10,12,22,0.7553173484984788,Dovish
높/VA;임금/NNG;인상/NNG,8,14,22,0.5179318961132426,Dovish
동발/NNG,16,20,36,0.7251046545585396,Dovish
사들일/VV,6,12,18,0.4531904090990872,Dovish
신흥국/NNG;성장/NNG;둔화/NNG,8,11,19,0.6591860495986723,Dovish
편리/NNG,24,37,61,0.5879226928853023,Dovish
날갯짓/NNG,8,23,31,0.31526289328632157,Dovish
그적/NNG,1,48,49,0.01888293371246197,Dovish
소비자/NNG;물가/NNG;상승률/NNG;가격/NNG;하락/NNG,8,12,20,0.604253878798783,Dovish
바쁘/VA,13,16,29,0.7364344147860167,Dovish
불완전판매/NNG,11,35,46,0.28486254286228335,Dovish
타국/NNG,20,24,44,0.7553173484984788,Dovish
예상/NNG;하향/NNG,7,11,18,0.5767877933988383,Dovish
출수/NNG,11,15,26,0.6646792666786613,Dovish
두두두두/MAG,43,59,102,0.6605826302122288,Dovish
지표/NNG;금리/NNG;급등/NNG,9,12,21,0.6797856136486309,Dovish
進退/NNG,6,16,22,0.3398928068243154,Dovish
금리/NNG;매우/MAG;낮/VA,10,34,44,0.26658259358769837,Dovish
시장성/NNG,96,119,215,0.7311979709834012,Dovish
경영자/NNG,3,15,18,0.1812761636396349,Dovish
온다면/VV,10,12,22,0.7553173484984788,Dovish
맞은편/NNG,8,13,21,0.5577728111988766,Dovish
신재정협약/NNG,14,37,51,0.34295490418309305,Dovish
얽혀/VV,10,17,27,0.5331651871753967,Dovish
때마침/MAG,9,14,23,0.5826733831273979,Dovish
아동/NNG,25,35,60,0.6474148701415532,Dovish
영입/NNG,20,33,53,0.5493217079988937,Dovish
조언/NNG,107,150,257,0.6465516503146977,Dovish
한남/NNG,13,21,34,0.5610928874560127,Dovish
요율/NNG,10,31,41,0.2923809090961853,Dovish
방안/NNG,1127,1355,2482,0.7538680310770055,Dovish
주주제안/NNG,28,35,63,0.7251046545585396,Dovish
자금/NNG;유입/NNG;증가/NNG,7,10,17,0.6344665727387221,Dovish
관여/NNG,33,71,104,0.42127559155689803,Dovish
빨리/MAG;금리/NNG;인하/NNG,6,11,17,0.49438953719900425,Dovish
미뤄볼/VV,7,10,17,0.6344665727387221,Dovish
선진국/NNG;금리/NNG;상승/NNG,2,15,17,0.1208507757597566,Dovish
체납액/NNG,5,13,18,0.34860800699929784,Dovish
재정거래/NNG,95,139,234,0.6194689045239322,Dovish
결합/NNG,56,75,131,0.6767643442546369,Dovish
구별/NNG,13,24,37,0.49095627652401114,Dovish
도민/NNG,28,35,63,0.7251046545585396,Dovish
마비/NNG,7,17,24,0.37321563102277766,Dovish
고속도/NNG,11,15,26,0.6646792666786613,Dovish
액면/NNG,6,11,17,0.49438953719900425,Dovish
용선/NNG,6,15,21,0.3625523272792698,Dovish
과당경쟁/NNG,4,20,24,0.1812761636396349,Dovish
모하메드/NNG,23,29,52,0.7188537523640693,Dovish
중장기물/NNG;금리/NNG;상승/NNG,9,14,23,0.5826733831273979,Dovish
지극히/MAG,14,20,34,0.6344665727387221,Dovish
렌치/NNG,6,25,31,0.21753139636756186,Dovish
자산유동화증권/NNG,36,70,106,0.4661387065019183,Dovish
한눈/NNG,7,10,17,0.6344665727387221,Dovish
세미/NNG,10,22,32,0.41199128099917026,Dovish
펜딩/NNG,11,16,27,0.6231368125112449,Dovish
복리/NNG,45,56,101,0.7283417289092473,Dovish
재무상태표/NNG,9,20,29,0.4078713681891785,Dovish
금리/NNG;인하/NNG;가능성/NNG;하락/NNG,11,14,25,0.7121563571557085,Dovish
괴물/NNG,2,21,23,0.08632198268554042,Dovish
결정짓/VV,10,18,28,0.5035448989989859,Dovish
재정/NNG;부양/NNG,8,10,18,0.7251046545585396,Dovish
무다라바/NNG,1,16,17,0.0566488011373859,Dovish
지수/NNG;떨어/VV,10,12,22,0.7553173484984788,Dovish
선반/NNG,14,30,44,0.42297771515914806,Dovish
보증료/NNG,25,57,82,0.39753544657814666,Dovish
안팎/NNG,148,179,327,0.7494098385102224,Dovish
시장점유율/NNG,72,110,182,0.5932674446388051,Dovish
주주총회/NNG,63,102,165,0.5598234465341666,Dovish
우동/NNG,14,31,45,0.4093332727346594,Dovish
잦아들/VV,23,44,67,0.47378997314904575,Dovish
의뢰/NNG,18,22,40,0.7415843057985064,Dovish
용용/NNG,451,677,1128,0.6038076056238946,Dovish
현장점검/NNG,16,22,38,0.6591860495986723,Dovish
한해서/VV,10,15,25,0.604253878798783,Dovish
경찰/NNG,35,48,83,0.6609026799361688,Dovish
인정비율/NNG,13,16,29,0.7364344147860167,Dovish
주범/NNG,26,32,58,0.7364344147860167,Dovish
조만간/MAG,160,193,353,0.7514037871072949,Dovish
대졸/NNG,9,13,22,0.6274944125987362,Dovish
해온/VV,16,21,37,0.6905758614843234,Dovish
시가총액비중/NNG,10,13,23,0.6972160139985957,Dovish
거시/NNG;하방/NNG;위험/NNG,5,12,17,0.3776586742492394,Dovish
물질/NNG,23,36,59,0.5790766338488337,Dovish
가족/NNG,58,77,135,0.6827284085129107,Dovish
완화/NNG;줄/VV,7,10,17,0.6344665727387221,Dovish
상한/NNG,159,192,351,0.7505966150703631,Dovish
매출/NNG;둔화/NNG,10,12,22,0.7553173484984788,Dovish
소비자/NNG;물가/NNG;경계/NNG,13,17,30,0.6931147433280157,Dovish
진정책/NNG,9,11,20,0.7415843057985064,Dovish
기위/NNG,13,47,60,0.25070107737396313,Dovish
스위프트/NNG,8,12,20,0.604253878798783,Dovish
혐오/NNG,7,10,17,0.6344665727387221,Dovish
기준등급/NNG,35,59,94,0.537683536219256,Dovish
범일/NNG,13,32,45,0.36821720739300834,Dovish
경제/NNG;확장/NNG,15,18,33,0.7553173484984786,Dovish
친화/NNG,56,79,135,0.6424977951784527,Dovish
임금/NNG;물가/NNG;상승/NNG,21,29,50,0.6563447304193677,Dovish
특수목적회사/NNG,10,14,24,0.6474148701415533,Dovish
축인/VV,7,11,18,0.5767877933988383,Dovish
정치/NNG;불확실성/NNG,44,53,97,0.7524670943532014,Dovish
크레딧/NNG;투자심리/NNG;개선/NNG,8,15,23,0.4834031030390264,Dovish
중소기업중앙회/NNG,5,17,22,0.26658259358769837,Dovish
내정자/NNG,22,39,61,0.5112917435989701,Dovish
불어나/VV,13,17,30,0.6931147433280157,Dovish
자금/NNG;늘/VV,8,13,21,0.5577728111988766,Dovish
단기/NNG;금리/NNG;인상/NNG,23,41,64,0.5084575321599516,Dovish
공동개발/NNG,8,12,20,0.604253878798783,Dovish
지양/NNG,22,31,53,0.6432380000116076,Dovish
배당기준일/NNG,5,12,17,0.3776586742492394,Dovish
권권/MAG,18,48,66,0.33989280682431544,Dovish
투자금액/NNG,53,82,135,0.5858315044451615,Dovish
금융시장/NNG;긍정적/VAX,7,12,19,0.5287221439489351,Dovish
스케일/NNG,7,34,41,0.18660781551138883,Dovish
할부금융/NNG,31,40,71,0.7024451341035851,Dovish
밸류에이션/NNG,234,291,525,0.7288423074170888,Dovish
글로벌/NNG;완화/NNG,11,17,28,0.5864817058929364,Dovish
저명/NNG,12,21,33,0.5179318961132425,Dovish
배고프/VV,1,23,24,0.039407861660790196,Dovish
등기/NNG,25,30,55,0.7553173484984788,Dovish
미/NNG;금리/NNG;오르/VV,8,12,20,0.604253878798783,Dovish
죽전/NNG,6,12,18,0.4531904090990872,Dovish
토스/NNG,67,91,158,0.6673353276843702,Dovish
부동산펀드/NNG,16,25,41,0.5800837236468316,Dovish
해태/NNG,11,15,26,0.6646792666786613,Dovish
자동차기업/NNG,7,12,19,0.5287221439489351,Dovish
정책과제/NNG,12,19,31,0.5724510430725313,Dovish
굵직/NNG,25,51,76,0.44430432264616393,Dovish
일어날지/VV,7,10,17,0.6344665727387221,Dovish
화이트리스트/NNG,6,22,28,0.24719476859950212,Dovish
평이/NNG,11,21,32,0.4747709047704723,Dovish
워워워/MAG,5,24,29,0.1888293371246197,Dovish
정기/NNG,290,354,644,0.7425153595408773,Dovish
기대/NNG;줄/VV,11,18,29,0.5538993888988843,Dovish
단기/NNG;변동성/NNG;확대/NNG,10,15,25,0.604253878798783,Dovish
스팟/NNG,11,16,27,0.6231368125112449,Dovish
채의/NNG,15,19,34,0.715563803840664,Dovish
대략/NNG,22,34,56,0.5864817058929364,Dovish
우산/NNG,24,59,83,0.3686972819789184,Dovish
공제조합/NNG,8,12,20,0.604253878798783,Dovish
공공자금/NNG,11,18,29,0.5538993888988843,Dovish
생겨나/VV,13,20,33,0.5891475318288134,Dovish
챙기/VV,27,33,60,0.7415843057985064,Dovish
물가/NNG;하향/NNG,25,30,55,0.7553173484984788,Dovish
채권투자/NNG;위험/NNG,7,10,17,0.6344665727387221,Dovish
금리/NNG;인하/NNG;가능성/NNG;약화/NNG,14,29,43,0.43756315361291176,Dovish
각광/NNG,12,22,34,0.49438953719900425,Dovish
델피/NNG,8,16,24,0.4531904090990872,Dovish
오늘날/NNG,18,27,45,0.604253878798783,Dovish
제반/NNG,46,72,118,0.5790766338488337,Dovish
위배/NNG,8,17,25,0.4265321497403174,Dovish
시중은행채/NNG,11,19,30,0.5247467894831536,Dovish
안전자산/NNG;선호/NNG;확대/NNG,12,18,30,0.604253878798783,Dovish
손실/NNG;흡수/NNG,31,38,69,0.7394159306353528,Dovish
물가/NNG;임금/NNG;상승/NNG,10,12,22,0.7553173484984788,Dovish
소비자/NNG;물가/NNG;하락/NNG,8,12,20,0.604253878798783,Dovish
정책/NNG;결정/NNG;내리/VV,8,12,20,0.604253878798783,Dovish
제하/VV,10,13,23,0.6972160139985957,Dovish
형식/NNG,38,53,91,0.6498579451232194,Dovish
제약요인/NNG,49,62,111,0.716333227285654,Dovish
섹터스프레드/NNG,8,13,21,0.5577728111988766,Dovish
크레딧/NNG;거래/NNG;증가/NNG,6,14,20,0.3884489220849319,Dovish
생산업체/NNG,13,19,32,0.6201552966619088,Dovish
실링/NNG,36,47,83,0.6942491373432825,Dovish
예상/NNG;매파/NNG,21,30,51,0.6344665727387221,Dovish
희소성/NNG,9,11,20,0.7415843057985064,Dovish
녹녹/NNG,3,44,47,0.06179869214987553,Dovish
시추기/NNG,7,16,23,0.3965416079617013,Dovish
볼드/NNG,33,56,89,0.5341172678667815,Dovish
로열티/NNG,4,15,19,0.2417015515195132,Dovish
일임/NNG,15,32,47,0.42486600853039425,Dovish
횡령/NNG,4,23,27,0.15763144664316078,Dovish
국채시장/NNG;안정/NNG,10,12,22,0.7553173484984788,Dovish
신용경색/NNG,133,391,524,0.3083085647579468,Dovish
미주/NNG,12,22,34,0.49438953719900425,Dovish
헌법/NNG,36,47,83,0.6942491373432825,Dovish
차입부채/NNG,44,74,118,0.5389291351448604,Dovish
성장주/NNG,76,134,210,0.5140667327094124,Dovish
부실/NNG;확대/NNG,9,13,22,0.6274944125987362,Dovish
세율/NNG,101,123,224,0.7442639238863059,Dovish
시장구조/NNG,13,18,31,0.6546083686986816,Dovish
금리/NNG;좋/VA,3,15,18,0.1812761636396349,Dovish
초고/NNG,3,18,21,0.15106346969969575,Dovish
아꼈/VV,5,15,20,0.3021269393993915,Dovish
폐막/NNG,6,11,17,0.49438953719900425,Dovish
대수/NNG,13,17,30,0.6931147433280157,Dovish
취급액/NNG,60,72,132,0.7553173484984786,Dovish
투자처/NNG,75,96,171,0.7081100142173238,Dovish
손잡/VV,10,15,25,0.604253878798783,Dovish
소비세/NNG,42,71,113,0.5361689347087792,Dovish
업그레이드/NNG,34,41,75,0.7516328736277544,Dovish
액션/NNG,43,62,105,0.6286189545567984,Dovish
역발상/NNG,7,10,17,0.6344665727387221,Dovish
금리/NNG;역전/NNG;확대/NNG,8,10,18,0.7251046545585396,Dovish
금융리스/NNG,3,16,19,0.1699464034121577,Dovish
채부/NNG,3,48,51,0.0566488011373859,Dovish
해암/NNG,7,16,23,0.3965416079617013,Dovish
관람/NNG,10,15,25,0.604253878798783,Dovish
선불/NNG,7,11,18,0.5767877933988383,Dovish
맡길/VV,7,10,17,0.6344665727387221,Dovish
재정/NNG;지출/NNG;증가/NNG,8,12,20,0.604253878798783,Dovish
혼인/NNG,12,20,32,0.5438284909189046,Dovish
종목선정/NNG,5,12,17,0.3776586742492394,Dovish
예상/NNG;하락/NNG,9,18,27,0.45319040909908725,Dovish
파죽지세/NNG,11,15,26,0.6646792666786613,Dovish
유통산업/NNG,5,13,18,0.34860800699929784,Dovish
궁금/NNG,49,67,116,0.6628755237568739,Dovish
민심/NNG,36,48,84,0.6797856136486309,Dovish
지수/NNG;상승/NNG;견인/NNG,18,31,49,0.5262856363731335,Dovish
크레딧/NNG;시장/NNG;약세/NNG,48,58,106,0.7501082633364201,Dovish
경제/NNG;자신/NNG,4,15,19,0.2417015515195132,Dovish
회복/NNG;제약/NNG,9,20,29,0.4078713681891785,Dovish
베일리/NNG,8,15,23,0.4834031030390264,Dovish
억눌린/VV,6,12,18,0.4531904090990872,Dovish
대환/NNG,46,86,132,0.4848083446176282,Dovish
금리/NNG;하방/NNG;경직/NNG,14,21,35,0.6042538787987829,Dovish
타격/NNG;줄/VV,8,20,28,0.3625523272792698,Dovish
지지층/NNG,16,38,54,0.38163402871502083,Dovish
경제재/NNG,1,18,19,0.05035448989989858,Dovish
고안/NNG,14,18,32,0.7049628585985802,Dovish
긴박/NNG,8,11,19,0.6591860495986723,Dovish
실손/NNG,12,30,42,0.3625523272792698,Dovish
보름/NNG,9,13,22,0.6274944125987362,Dovish
백인/NNG,15,31,46,0.4385713636442779,Dovish
신용경색/NNG;완화/NNG,3,25,28,0.10876569818378093,Dovish
위험자산/NNG;가격/NNG;상승/NNG,12,17,29,0.639798224610476,Dovish
주주배정/NNG,8,13,21,0.5577728111988766,Dovish
통화정책/NNG;민감/NNG;금리/NNG;오르/VV,5,13,18,0.34860800699929784,Dovish
인과/NNG,11,14,25,0.7121563571557085,Dovish
심리/NNG;약화/NNG,12,15,27,0.7251046545585396,Dovish
병합/NNG,8,12,20,0.604253878798783,Dovish
부결/NNG,48,73,121,0.595976428404279,Dovish
어둠/NNG,20,30,50,0.604253878798783,Dovish
미래현금흐름/NNG,10,14,24,0.6474148701415533,Dovish
잃어버린/VV,17,23,40,0.6699336482334333,Dovish
관행/NNG,57,111,168,0.46543879853419773,Dovish
목표비율/NNG,10,32,42,0.28324400568692953,Dovish
전망/NNG;줄/VV,3,22,25,0.12359738429975106,Dovish
온전히/MAG,37,49,86,0.6844100055782133,Dovish
들어왔/VV,70,109,179,0.5820794245309378,Dovish
야구/NNG,9,14,23,0.5826733831273979,Dovish
시달렸/VV,8,10,18,0.7251046545585396,Dovish
실상/NNG,19,27,46,0.6378235387320487,Dovish
변환/NNG,24,57,81,0.3816340287150208,Dovish
투자/NNG;수요/NNG;위축/NNG,10,14,24,0.6474148701415533,Dovish
치사/NNG,7,13,20,0.48805120979901695,Dovish
운하/NNG,3,15,18,0.1812761636396349,Dovish
경제/NNG;충격/NNG,18,28,46,0.5826733831273979,Dovish
거주자/NNG,73,104,177,0.6362096127737186,Dovish
부실자산/NNG,50,64,114,0.7081100142173238,Dovish
본다고/VV,21,29,50,0.6563447304193677,Dovish
라질/NNG,4,14,18,0.2589659480566213,Dovish
중도파/NNG,16,31,47,0.46780945455389644,Dovish
공론/NNG,11,21,32,0.4747709047704723,Dovish
세계/NNG;경제/NNG;불확실성/NNG,7,17,24,0.37321563102277766,Dovish
내재가치/NNG,9,18,27,0.45319040909908725,Dovish
역수/NNG,8,10,18,0.7251046545585396,Dovish
後者/NNG,9,14,23,0.5826733831273979,Dovish
가시권/NNG,32,60,92,0.4834031030390264,Dovish
담보물/NNG,8,23,31,0.31526289328632157,Dovish
소비자보호/NNG,14,21,35,0.6042538787987829,Dovish
사후관리/NNG,16,21,37,0.6905758614843234,Dovish
중앙일보/NNG,10,12,22,0.7553173484984788,Dovish
부담금/NNG,46,96,142,0.43430747538662523,Dovish
경제/NNG;불안/NNG,14,17,31,0.7464312620455553,Dovish
예금인출사태/NNG,6,14,20,0.3884489220849319,Dovish
제정/NNG,76,103,179,0.668785846437488,Dovish
연합자산관리/NNG,338,439,777,0.6978512905489361,Dovish
상위등급/NNG,290,439,729,0.5987481486958328,Dovish
쏠린/VV,42,62,104,0.6139999091019891,Dovish
위안화예금/NNG,6,20,26,0.2719142454594523,Dovish
지능/NNG,6,14,20,0.3884489220849319,Dovish
악용/NNG,8,13,21,0.5577728111988766,Dovish
가량/NNG,1341,1654,2995,0.7348589342223408,Dovish
국채/NNG;공급/NNG;증가/NNG,7,21,28,0.30212693939939145,Dovish
사들이/VV,73,106,179,0.6242056578157239,Dovish
기독/NNG,5,12,17,0.3776586742492394,Dovish
운용리스/NNG,2,16,18,0.1132976022747718,Dovish
합류/NNG,39,51,90,0.6931147433280158,Dovish
비트/NNG,47,71,118,0.5999985697931578,Dovish
보너스/NNG,42,69,111,0.5517100632510626,Dovish
떠받치/VV,17,40,57,0.3852118477342241,Dovish
경착륙/NNG;우려/NNG,7,11,18,0.5767877933988383,Dovish
수요/NNG;견조/NNG,30,40,70,0.6797856136486308,Dovish
공급/NNG;부담/NNG;완화/NNG,11,17,28,0.5864817058929364,Dovish
급급/NNG,1004,1364,2368,0.6671600743922047,Dovish
도출/NNG,98,122,220,0.7280763949460746,Dovish
국채/NNG;금리/NNG;내리/VV,53,71,124,0.676594131894412,Dovish
메뉴/NNG,16,21,37,0.6905758614843234,Dovish
생산/NNG;감소/NNG,15,25,40,0.5438284909189046,Dovish
재정/NNG;악화/NNG,21,28,49,0.6797856136486309,Dovish
자금/NNG;이탈/NNG,15,27,42,0.5035448989989858,Dovish
멀리/MAG,30,78,108,0.3486080069992978,Dovish
고용시장/NNG;강하/VA,16,27,43,0.5371145589322516,Dovish
유로본드/NNG,16,70,86,0.20717275844529703,Dovish
소망/NNG,14,26,40,0.48805120979901695,Dovish
실적/NNG;증가/NNG,9,26,35,0.3137472062993681,Dovish
주저/NNG,71,98,169,0.6566636540007182,Dovish
세이렌/NNG,1,24,25,0.03776586742492394,Dovish
씨씨씨씨/MAG,6,18,24,0.3021269393993915,Dovish
젊은층/NNG,15,23,38,0.5911179249118529,Dovish
金石/NNG,1,47,48,0.019284698259535625,Dovish
곡물/NNG,77,100,177,0.6979132300125943,Dovish
행정명령/NNG,17,22,39,0.7003851776985893,Dovish
글로벌/NNG;유동성/NNG;확대/NNG,16,21,37,0.6905758614843234,Dovish
오퍼레이션/NNG,29,130,159,0.20219264405959278,Dovish
번달/NNG,4,13,17,0.2788864055994383,Dovish
예금이자/NNG,7,11,18,0.5767877933988383,Dovish
행이/NNG,60,75,135,0.7251046545585395,Dovish
파급경로/NNG,32,48,80,0.604253878798783,Dovish
회생/NNG,92,121,213,0.6891490518531574,Dovish
경제/NNG;지표/NNG;긍정적/VAX,9,16,25,0.5098392102364732,Dovish
자산배분전략/NNG,15,122,137,0.11144026453256242,Dovish
기업회생절차/NNG,11,32,43,0.31156840625562243,Dovish
경영난/NNG,11,23,34,0.4334864782686921,Dovish
내정/NNG,10,19,29,0.47704253589377604,Dovish
총요소생산성/NNG,8,28,36,0.2589659480566213,Dovish
최대/NNG;인하/NNG,9,18,27,0.45319040909908725,Dovish
학적/NNG,12,15,27,0.7251046545585396,Dovish
그리스사태/NNG,21,31,52,0.6139999091019891,Dovish
각기/MAG,19,28,47,0.6150441266344755,Dovish
선조/NNG,10,14,24,0.6474148701415533,Dovish
셰어/NNG,6,14,20,0.3884489220849319,Dovish
편익/NNG,18,24,42,0.6797856136486309,Dovish
동일등급/NNG,96,167,263,0.5210332847127229,Dovish
정서/NNG,11,25,36,0.3988075600071967,Dovish
현물시장/NNG,63,100,163,0.57101991546485,Dovish
빈도/NNG,52,77,129,0.6121013317701958,Dovish
좌측/NNG,38,60,98,0.5740411848588438,Dovish
전례/NNG,66,87,153,0.6875992413917186,Dovish
수출/NNG;제한/NNG,10,18,28,0.5035448989989859,Dovish
스튜어드십코드/NNG,23,49,72,0.4254440575215921,Dovish
동절기/NNG,10,12,22,0.7553173484984788,Dovish
대외/NNG;충격/NNG,20,28,48,0.6474148701415533,Dovish
부동산/NNG;경기/NNG;회복/NNG,12,18,30,0.604253878798783,Dovish
원환/NNG,9,18,27,0.45319040909908725,Dovish
전국인민대표대회/NNG,11,59,70,0.16898625424033759,Dovish
천주/NNG,4,31,35,0.11695236363847411,Dovish
억울/NNG,4,13,17,0.2788864055994383,Dovish
증명/NNG,52,63,115,0.7481238499413503,Dovish
부정적/VAX;효과/NNG,22,27,49,0.7385325185318458,Dovish
경제/NNG;역성장/NNG,5,12,17,0.3776586742492394,Dovish
대출/NNG;위험/NNG,5,17,22,0.26658259358769837,Dovish
핵협상/NNG,5,18,23,0.25177244949949296,Dovish
이어받/VV,17,45,62,0.3424105313193103,Dovish
페소/NNG,455,551,1006,0.7484632890747176,Dovish
이격도/NNG,7,19,26,0.3339297751256432,Dovish
탈탈탈탈/MAG,34,78,112,0.39508907459920417,Dovish
주식자산/NNG,14,18,32,0.7049628585985802,Dovish
유망/NNG,65,110,175,0.5355886652989212,Dovish
여객기/NNG,10,24,34,0.3776586742492394,Dovish
역전세난/NNG,4,23,27,0.15763144664316078,Dovish
피인수/NNG,6,17,23,0.319899112305238,Dovish
엘엔지/NNG,14,25,39,0.5075732581909776,Dovish
좌파/NNG,58,96,154,0.5476050776613971,Dovish
가급적/VAX,16,20,36,0.7251046545585396,Dovish
채권/NNG;금리/NNG;상승/NNG;압력/NNG;높/VV,9,18,27,0.45319040909908725,Dovish
채안펀드/NNG,119,254,373,0.4246429817542628,Dovish
지점/NNG,543,804,1347,0.6121452540816029,Dovish
컨소시엄/NNG,24,57,81,0.3816340287150208,Dovish
실시/NNG,855,1155,2010,0.6709572290557914,Dovish
상장법인/NNG,8,13,21,0.5577728111988766,Dovish
예상/NNG;강하/VA,104,128,232,0.7364344147860167,Dovish
대출상품/NNG,53,86,139,0.5585835274942238,Dovish
페그제/NNG,2,19,21,0.09540850717875521,Dovish
주택매매/NNG,169,218,387,0.7026530196123463,Dovish
차유/NNG,52,64,116,0.7364344147860167,Dovish
부득불/MAG,3,16,19,0.1699464034121577,Dovish
앞선/VV,210,265,475,0.7182640446098741,Dovish
통안채/NNG;오르/VV,4,15,19,0.2417015515195132,Dovish
수쿠크/NNG,1,167,168,0.005427430049090865,Dovish
높임/NNG,9,12,21,0.6797856136486309,Dovish
시계열/NNG,83,104,187,0.7233616145235431,Dovish
정치/NNG;위험/NNG,33,54,87,0.5538993888988845,Dovish
트럼프리스크/NNG,6,19,25,0.2862255215362656,Dovish
신용/NNG;불안/NNG,7,20,27,0.31723328636936104,Dovish
금의/NNG,4,25,29,0.1450209309117079,Dovish
구조화채권/NNG,36,109,145,0.29935513261591085,Dovish
조작/NNG,59,146,205,0.3662771799567965,Dovish
과징금/NNG,24,37,61,0.5879226928853023,Dovish
남용/NNG,6,19,25,0.2862255215362656,Dovish
공인/NNG,7,12,19,0.5287221439489351,Dovish
혼동/NNG,8,11,19,0.6591860495986723,Dovish
경과물/NNG,21,26,47,0.7320768146985255,Dovish
불붙/VV,8,20,28,0.3625523272792698,Dovish
매집/NNG,18,24,42,0.6797856136486309,Dovish
파이/NNG,16,73,89,0.19865880946809303,Dovish
법률/NNG,77,134,211,0.5208307686661152,Dovish
대출심사/NNG,20,28,48,0.6474148701415533,Dovish
수입/NNG;확대/NNG,4,13,17,0.2788864055994383,Dovish
재정건전화계획/NNG,9,16,25,0.5098392102364732,Dovish
찍기/NNG,9,17,26,0.47984866845785706,Dovish
현역/NNG,5,14,19,0.32370743507077665,Dovish
특정지역/NNG,9,15,24,0.5438284909189047,Dovish
고속/NNG,14,22,36,0.5767877933988383,Dovish
특유/NNG,8,15,23,0.4834031030390264,Dovish
인베스트먼트/NNG,69,92,161,0.6797856136486309,Dovish
채무자/NNG,31,54,85,0.5203297289656187,Dovish
재생/NNG,26,36,62,0.6546083686986816,Dovish
정책/NNG;모멘텀/NNG,10,23,33,0.39407861660790194,Dovish
들어간다/VV,7,22,29,0.28839389669941917,Dovish
전철/NNG,12,35,47,0.3107591376679455,Dovish
유효수요/NNG,376,499,875,0.6829643038928128,Dovish
국채입찰/NNG;부진/NNG,17,26,43,0.5926336118988063,Dovish
환급/NNG,55,116,171,0.42974952586982407,Dovish
장래/NNG,15,23,38,0.5911179249118529,Dovish
연사/NNG,7,19,26,0.3339297751256432,Dovish
부채/NNG;줄/VV,16,20,36,0.7251046545585396,Dovish
유동성/NNG;확보/NNG,73,91,164,0.7270967003128213,Dovish
초우/NNG,6,18,24,0.3021269393993915,Dovish
도인/NNG,99,181,280,0.49575525415259264,Dovish
고용/NNG;증가/NNG;둔화/NNG,17,23,40,0.6699336482334333,Dovish
연소/NNG,9,19,28,0.42933828230439847,Dovish
줄곧/MAG,43,63,106,0.6186408759130397,Dovish
리트/NNG,55,67,122,0.7440439552373074,Dovish
지도/NNG,62,115,177,0.4886574845937984,Dovish
총장/NNG,11,22,33,0.4531904090990872,Dovish
투자기업/NNG,10,16,26,0.5664880113738591,Dovish
감익/NNG,10,15,25,0.604253878798783,Dovish
제조업/NNG;pmi/NNG;하락/NNG,9,19,28,0.42933828230439847,Dovish
만좌/NNG,11,15,26,0.6646792666786613,Dovish
금남/NNG,14,31,45,0.4093332727346594,Dovish
양분/NNG,11,16,27,0.6231368125112449,Dovish
항소/NNG,10,14,24,0.6474148701415533,Dovish
될수록/VV,8,10,18,0.7251046545585396,Dovish
국채/NNG;수급/NNG;부담/NNG,7,12,19,0.5287221439489351,Dovish
위험자산/NNG;강세/NNG,13,27,40,0.43640557913245437,Dovish
경기/NNG;충격/NNG,22,33,55,0.6042538787987829,Dovish
원유/NNG;재고/NNG;감소/NNG,8,10,18,0.7251046545585396,Dovish
국채/NNG;발행/NNG;증가/NNG,31,51,82,0.5509373600812433,Dovish
감면/NNG,128,180,308,0.6445374707187018,Dovish
주식수/NNG,10,21,31,0.4316099134277021,Dovish
주저앉/VV,6,12,18,0.4531904090990872,Dovish
배당액/NNG,3,21,24,0.12948297402831063,Dovish
모간/NNG,13,24,37,0.49095627652401114,Dovish
대장주/NNG,52,86,138,0.5480442156547101,Dovish
통화정책/NNG;되돌/VV,4,21,25,0.17264396537108084,Dovish
내각/NNG,41,49,90,0.7584002764515337,Dovish
챗봇/NNG,8,14,22,0.5179318961132426,Dovish
사와/NNG,14,18,32,0.7049628585985802,Dovish
지날/VV,9,13,22,0.6274944125987362,Dovish
알려졌/VV,218,268,486,0.7372799192806047,Dovish
간별/NNG,61,106,167,0.5215965085857419,Dovish
중위험중수익/NNG,12,17,29,0.639798224610476,Dovish
무급/NNG,7,32,39,0.19827080398085065,Dovish
실트/NNG,14,31,45,0.4093332727346594,Dovish
가격산정/NNG,8,10,18,0.7251046545585396,Dovish
무담보/NNG,28,46,74,0.5517100632510628,Dovish
실험/NNG,34,45,79,0.6848210626386206,Dovish
면허/NNG,20,41,61,0.4421369844869144,Dovish
캐파/NNG,12,20,32,0.5438284909189046,Dovish
주채무계열/NNG,11,17,28,0.5864817058929364,Dovish
신용보증기금/NNG,43,58,101,0.6719719859055431,Dovish
증서/NNG,14,22,36,0.5767877933988383,Dovish
교보/NNG,29,72,101,0.36507005177426477,Dovish
판도/NNG,12,21,33,0.5179318961132425,Dovish
주택가격/NNG;오르/VV,7,10,17,0.6344665727387221,Dovish
명지/NNG,7,17,24,0.37321563102277766,Dovish
져야/VV,11,16,27,0.6231368125112449,Dovish
적금/NNG,183,252,435,0.6582051179772457,Dovish
규범/NNG,10,20,30,0.45319040909908725,Dovish
국고채/NNG;입찰/NNG;부담/NNG,9,20,29,0.4078713681891785,Dovish
그만/MAG,12,18,30,0.604253878798783,Dovish
순자본비율/NNG,16,28,44,0.5179318961132426,Dovish
발행어음/NNG,77,108,185,0.6462159537153652,Dovish
디플레이션/NNG;압력/NNG,13,20,33,0.5891475318288134,Dovish
총액/NNG,203,243,446,0.7571823296058823,Dovish
국고채/NNG;금리/NNG;강세/NNG,11,15,26,0.6646792666786613,Dovish
인민정치협상회의/NNG,6,25,31,0.21753139636756186,Dovish
크레딧/NNG;스프레드/NNG;확대/NNG,8,13,21,0.5577728111988766,Dovish
검사/NNG,59,169,228,0.3164288063532088,Dovish
인플레이션/NNG;가속/NNG;우려/NNG,6,12,18,0.4531904090990872,Dovish
리턴/NNG,22,38,60,0.5247467894831536,Dovish
상실/NNG,74,109,183,0.6153411059327055,Dovish
주입/NNG,18,44,62,0.3707921528992532,Dovish
경구/NNG,2,16,18,0.1132976022747718,Dovish
주문량/NNG,9,13,22,0.6274944125987362,Dovish
보호무역주의/NNG,90,171,261,0.477042535893776,Dovish
일으켜/VV,7,12,19,0.5287221439489351,Dovish
브리프/NNG,11,24,35,0.41542454167416326,Dovish
과대/NNG,13,20,33,0.5891475318288134,Dovish
커버드본드/NNG,105,313,418,0.3040574629738285,Dovish
소액채권/NNG,3,19,22,0.1431127607681328,Dovish
연대/NNG,16,24,40,0.604253878798783,Dovish
리그/NNG,24,53,77,0.410436596919928,Dovish
기대/NNG;안전자산/NNG;선호/NNG,7,10,17,0.6344665727387221,Dovish
구포/NNG,7,16,23,0.3965416079617013,Dovish
장식/NNG,10,12,22,0.7553173484984788,Dovish
좁혀질/VV,22,36,58,0.5538993888988843,Dovish
기상악화/NNG,13,18,31,0.6546083686986816,Dovish
생산시설/NNG,25,45,70,0.5035448989989858,Dovish
결정변수/NNG,10,16,26,0.5664880113738591,Dovish
고소득층/NNG,21,26,47,0.7320768146985255,Dovish
하락/NNG;멈추/VV,6,16,22,0.3398928068243154,Dovish
회복국면/NNG,123,148,271,0.7532759502592936,Dovish
됐으며/VV,9,11,20,0.7415843057985064,Dovish
자연스레/MAG,32,43,75,0.6745159577288741,Dovish
여전채/NNG;스프레드/NNG;확대/NNG,8,12,20,0.604253878798783,Dovish
우려/NNG;금리/NNG;인하/NNG,14,18,32,0.7049628585985802,Dovish
확실시/NNG,13,27,40,0.43640557913245437,Dovish
소프트랜딩/NNG,21,50,71,0.38067994364323327,Dovish
재무/NNG;건전성/NNG;악화/NNG,9,11,20,0.7415843057985064,Dovish
선물옵션/NNG,12,35,47,0.3107591376679455,Dovish
해외/NNG;금리/NNG;상승/NNG,6,12,18,0.4531904090990872,Dovish
뇌물/NNG,7,13,20,0.48805120979901695,Dovish
변조/NNG,5,14,19,0.32370743507077665,Dovish
봉합/NNG,5,16,21,0.28324400568692953,Dovish
경관지구/NNG,2,16,18,0.1132976022747718,Dovish
재정/NNG;확장/NNG,13,18,31,0.6546083686986816,Dovish
매일신문/NNG,7,13,20,0.48805120979901695,Dovish
맡기/VV,30,43,73,0.6323587103708194,Dovish
통계국/NNG,57,99,156,0.5218556225989489,Dovish
독재/NNG,5,15,20,0.3021269393993915,Dovish
중소벤처기업부/NNG,14,23,37,0.5517100632510628,Dovish
인플레이션/NNG;강하/VA,10,22,32,0.41199128099917026,Dovish
필요지준/NNG,17,28,45,0.5503026396203202,Dovish
귀국/NNG,4,24,28,0.15106346969969575,Dovish
제로금리/NNG,69,167,236,0.37449267338726966,Dovish
미/NNG;금리/NNG;인상/NNG;우려/NNG,6,14,20,0.3884489220849319,Dovish
펀더멘털/NNG;개선/NNG,52,63,115,0.7481238499413503,Dovish
세액/NNG,5,17,22,0.26658259358769837,Dovish
편차/NNG,65,85,150,0.6931147433280157,Dovish
고래/NNG,5,22,27,0.20599564049958513,Dovish
경제력/NNG,7,17,24,0.37321563102277766,Dovish
고정자본/NNG,8,14,22,0.5179318961132426,Dovish
교전/NNG,6,13,19,0.4183296083991574,Dovish
민영화/NNG,33,42,75,0.7121563571557085,Dovish
동강/NNG,7,16,23,0.3965416079617013,Dovish
플레이/NNG,42,52,94,0.7320768146985255,Dovish
평사/NNG,13,26,39,0.4531904090990872,Dovish
위험자산/NNG;선호/NNG,55,73,128,0.6828896575465697,Dovish
현금유출액/NNG,9,12,21,0.6797856136486309,Dovish
석방/NNG,9,16,25,0.5098392102364732,Dovish
마크/NNG,35,60,95,0.5287221439489351,Dovish
수사/NNG,76,111,187,0.6205850647122636,Dovish
나타냈으며/VV,13,27,40,0.43640557913245437,Dovish
권한다/VV,15,21,36,0.6474148701415531,Dovish
여수신/NNG,26,38,64,0.6201552966619088,Dovish
前者/NNG,6,11,17,0.49438953719900425,Dovish
보유금액/NNG,12,22,34,0.49438953719900425,Dovish
보고/NNG,116,177,293,0.5940122876327019,Dovish
판매자/NNG,9,24,33,0.33989280682431544,Dovish
조직/NNG,110,192,302,0.5192806770927041,Dovish
반감/NNG,29,42,71,0.6258343744701681,Dovish
여사/NNG,4,21,25,0.17264396537108084,Dovish
지점망/NNG,7,12,19,0.5287221439489351,Dovish
수련/NNG,11,15,26,0.6646792666786613,Dovish
매매계약/NNG,11,23,34,0.4334864782686921,Dovish
특혜/NNG,4,13,17,0.2788864055994383,Dovish
사업체/NNG,21,35,56,0.5438284909189046,Dovish
자진/NNG,8,21,29,0.3452879307421617,Dovish
금융부채/NNG,43,57,100,0.6837609681144122,Dovish
주시/NNG,484,644,1128,0.6811930372793734,Dovish
쌀쌀/NNG,2,24,26,0.07553173484984788,Dovish
그룹사/NNG,19,44,63,0.3913917169492117,Dovish
건설/NNG;긍정적/VAX,8,11,19,0.6591860495986723,Dovish
부모/NNG,29,47,76,0.5592562495265332,Dovish
지프/NNG,8,10,18,0.7251046545585396,Dovish
빗금/NNG,1,23,24,0.039407861660790196,Dovish
골디락스/NNG,76,103,179,0.668785846437488,Dovish
원엔/NNG,102,137,239,0.6748236748628743,Dovish
캐쉬백/NNG,20,24,44,0.7553173484984788,Dovish
소매/NNG;판매/NNG;증가/NNG,27,37,64,0.6614130294959651,Dovish
글로벌/NNG;안전자산/NNG;선호/NNG,14,19,33,0.6678595502512864,Dovish
금융시장/NNG;변동성/NNG;완화/NNG,7,14,21,0.45319040909908725,Dovish
가격/NNG;고공행진/NNG,7,12,19,0.5287221439489351,Dovish
산단/VV,13,20,33,0.5891475318288134,Dovish
초읽기/NNG,9,35,44,0.23306935325095915,Dovish
가한/VV,12,23,35,0.4728943399294823,Dovish
상기/MAG,8,23,31,0.31526289328632157,Dovish
침침/NNG,33,42,75,0.7121563571557085,Dovish
보험기금/NNG,140,185,325,0.6859098083661861,Dovish
하락/NNG;제약/NNG,6,14,20,0.3884489220849319,Dovish
금리/NNG;인하/NNG;아니/VCN,13,22,35,0.5355886652989212,Dovish
비용/NNG;축소/NNG,8,10,18,0.7251046545585396,Dovish
다자녀/NNG,7,19,26,0.3339297751256432,Dovish
기대/NNG;소폭/MAG;상승/NNG,6,11,17,0.49438953719900425,Dovish
의견거절/NNG,3,15,18,0.1812761636396349,Dovish
노동조합/NNG,15,100,115,0.13595712272972615,Dovish
세월/NNG,36,54,90,0.604253878798783,Dovish
남전/NNG,6,11,17,0.49438953719900425,Dovish
차입비중/NNG,23,44,67,0.47378997314904575,Dovish
답했/VV,42,61,103,0.6240654813823496,Dovish
나토/NNG,11,22,33,0.4531904090990872,Dovish
일가/NNG,14,20,34,0.6344665727387221,Dovish
사무라이본드/NNG,10,12,22,0.7553173484984788,Dovish
커버넌트/NNG,5,25,30,0.1812761636396349,Dovish
쟁쟁쟁/MAG,25,34,59,0.666456483969246,Dovish
타제/NNG,20,27,47,0.6713931986653144,Dovish
안전자산/NNG;선호/NNG;높/VA,9,12,21,0.6797856136486309,Dovish
채권/NNG;금리/NNG;상승/NNG;압력/NNG,19,25,44,0.6888494218306125,Dovish
금리/NNG;내리/VV;못하/VX,10,18,28,0.5035448989989859,Dovish
각의/NNG,7,11,18,0.5767877933988383,Dovish
새누리당/NNG,7,17,24,0.37321563102277766,Dovish
발한다/VV,45,59,104,0.6913074037104721,Dovish
보인다면서/VV,11,16,27,0.6231368125112449,Dovish
회복/NNG;더디/VA,14,18,32,0.7049628585985802,Dovish
추측/NNG,62,76,138,0.7394159306353528,Dovish
금리/NNG;인상/NNG;우려/NNG;확대/NNG,6,12,18,0.4531904090990872,Dovish
낙낙/NNG,23,40,63,0.5211689704639503,Dovish
금물/NNG,14,20,34,0.6344665727387221,Dovish
체가/NNG,10,40,50,0.22659520454954363,Dovish
꼬리표/NNG,6,11,17,0.49438953719900425,Dovish
기술금융/NNG,21,48,69,0.3965416079617013,Dovish
획기/NNG,16,26,42,0.5577728111988766,Dovish
시그널링/NNG,7,14,21,0.45319040909908725,Dovish
실제/MAG,14,19,33,0.6678595502512864,Dovish
파이낸스/NNG,68,86,154,0.7166732050869286,Dovish
판매/NNG;감소/NNG,17,21,38,0.7337368528270936,Dovish
장기채권형/NNG,66,131,197,0.45664987787083605,Dovish
물가/NNG;상승률/NNG;예상/NNG;높/VA,11,17,28,0.5864817058929364,Dovish
물량/NNG;많/VA;않/VX,7,10,17,0.6344665727387221,Dovish
적자/NNG;축소/NNG,8,10,18,0.7251046545585396,Dovish
고용/NNG;안정/NNG,20,30,50,0.604253878798783,Dovish
대점/NNG,7,16,23,0.3965416079617013,Dovish
부채/NNG;많/VA,14,19,33,0.6678595502512864,Dovish
양적완화/NNG,651,1117,1768,0.5282488027278528,Dovish
글로벌/NNG;경기/NNG;회복/NNG,27,34,61,0.7197730026867856,Dovish
반환/NNG,37,104,141,0.3224624064743505,Dovish
소비/NNG;호조/NNG,10,14,24,0.6474148701415533,Dovish
경기/NNG;둔화/NNG;불확실성/NNG,7,11,18,0.5767877933988383,Dovish
디플레이션/NNG;탈피/NNG,5,24,29,0.1888293371246197,Dovish
유휴생산능력/NNG,10,15,25,0.604253878798783,Dovish
서면/NNG,8,38,46,0.19081701435751042,Dovish
산업단지/NNG,27,34,61,0.7197730026867856,Dovish
인류/NNG,11,14,25,0.7121563571557085,Dovish
착륙/NNG,11,29,40,0.34379962069585923,Dovish
극심한/VAX,43,73,116,0.5338955504455,Dovish
완만/NNG;경기/NNG;회복/NNG,13,22,35,0.5355886652989212,Dovish
비과세/NNG,69,83,152,0.753497306694868,Dovish
예보/NNG,75,113,188,0.6015801890695848,Dovish
설설/MAG,139,215,354,0.5859857382769592,Dovish
숏플레이/NNG,4,19,23,0.19081701435751042,Dovish
초과유동성/NNG,35,42,77,0.7553173484984786,Dovish
조국/NNG,39,70,109,0.5049835987104115,Dovish
극단주의/NNG,6,12,18,0.4531904090990872,Dovish
만국/NNG,6,11,17,0.49438953719900425,Dovish
기축통화국/NNG,36,48,84,0.6797856136486309,Dovish
수요/NNG;확충/NNG,8,15,23,0.4834031030390264,Dovish
프라임/NNG,40,56,96,0.6474148701415533,Dovish
실증분석/NNG,7,12,19,0.5287221439489351,Dovish
할인계수/NNG,21,61,82,0.3120327406911748,Dovish
금리/NNG;인상/NNG;그치/VV,9,11,20,0.7415843057985064,Dovish
재개발재건축/NNG,10,28,38,0.32370743507077665,Dovish
민생/NNG,266,321,587,0.7510819241143751,Dovish
산업군/NNG,20,29,49,0.6250902194470168,Dovish
출하량/NNG,12,54,66,0.20141795959959433,Dovish
조명/NNG,17,27,44,0.5706842188655172,Dovish
장바구니/NNG,9,17,26,0.47984866845785706,Dovish
현재가치/NNG,13,20,33,0.5891475318288134,Dovish
사별/NNG,41,53,94,0.7011625197382103,Dovish
밑줄/NNG,11,17,28,0.5864817058929364,Dovish
잡음/NNG,26,36,62,0.6546083686986816,Dovish
국민계정/NNG,8,11,19,0.6591860495986723,Dovish
금리/NNG;인하/NNG;가능성/NNG;크/VV,13,21,34,0.5610928874560127,Dovish
지지율/NNG,204,246,450,0.7516328736277544,Dovish
금리/NNG;오르/VV;금리/NNG;내리/VV,3,15,18,0.1812761636396349,Dovish
인쇄/NNG,7,10,17,0.6344665727387221,Dovish
단편/NNG,9,13,22,0.6274944125987362,Dovish
제도개선/NNG,71,119,190,0.5407818327064738,Dovish
레버리지/NNG;확대/NNG,12,22,34,0.49438953719900425,Dovish
단점/NNG,38,57,95,0.6042538787987829,Dovish
금괴/NNG,7,12,19,0.5287221439489351,Dovish
둔다면/VV,5,13,18,0.34860800699929784,Dovish
계산/NNG,405,493,898,0.7445927614001231,Dovish
기대/NNG;강하/VA,10,16,26,0.5664880113738591,Dovish
코시/NNG,60,106,166,0.5130457461499099,Dovish
소유권/NNG,17,45,62,0.3424105313193103,Dovish
다퉈/VV,6,14,20,0.3884489220849319,Dovish
irs/NNG;금리/NNG;하락/NNG,17,22,39,0.7003851776985893,Dovish
레인/NNG,31,45,76,0.6243956747587424,Dovish
fed/NNG;금리/NNG;인하/NNG;가능성/NNG;높/VA,5,13,18,0.34860800699929784,Dovish
촉매/NNG,15,23,38,0.5911179249118529,Dovish
하위등급/NNG,459,673,1132,0.6181705728870165,Dovish
글로벌/NNG;유동성/NNG;증가/NNG,8,16,24,0.4531904090990872,Dovish
랭크/NNG,8,11,19,0.6591860495986723,Dovish
구조화/NNG,94,116,210,0.7344810078502448,Dovish
기대수익/NNG,53,76,129,0.6320813600592533,Dovish
접하/VV,6,16,22,0.3398928068243154,Dovish
기업/NNG;실적/NNG;부진/NNG;우려/NNG,7,10,17,0.6344665727387221,Dovish
부채비율/NNG;증가/NNG,14,26,40,0.48805120979901695,Dovish
과열/NNG;우려/NNG,6,15,21,0.3625523272792698,Dovish
협정/NNG,50,64,114,0.7081100142173238,Dovish
物物/NNG,1,17,18,0.053316518717539674,Dovish
모형/NNG,115,244,359,0.42718768070815605,Dovish
부리/NNG,10,18,28,0.5035448989989859,Dovish
순매도우위/NNG,24,43,67,0.5058869682966555,Dovish
지칭/NNG,21,40,61,0.4758499295540416,Dovish
세일/NNG,23,29,52,0.7188537523640693,Dovish
산마/NNG,7,16,23,0.3965416079617013,Dovish
체제/NNG,135,185,320,0.6614130294959651,Dovish
증감액/NNG,35,57,92,0.5565496252094053,Dovish
오가/VV,24,32,56,0.6797856136486308,Dovish
변함없/VA,24,30,54,0.7251046545585396,Dovish
농가/NNG,16,21,37,0.6905758614843234,Dovish
거센/VA,15,20,35,0.6797856136486308,Dovish
근래/NNG,20,36,56,0.5035448989989859,Dovish
설비/NNG;투자/NNG;회복/NNG,13,16,29,0.7364344147860167,Dovish
특별히/MAG,52,86,138,0.5480442156547101,Dovish
유가/NNG;급락/NNG,40,53,93,0.6840609948665468,Dovish
결집/NNG,11,27,38,0.3692662592659229,Dovish
가권지수/NNG,97,117,214,0.7514439261984865,Dovish
기타공공기관/NNG,8,24,32,0.3021269393993915,Dovish
격담/NNG,26,37,63,0.6369162506257442,Dovish
수요/NNG;견고/NNG,9,13,22,0.6274944125987362,Dovish
중징계/NNG,7,11,18,0.5767877933988383,Dovish
범우/NNG,7,12,19,0.5287221439489351,Dovish
칼칼/NNG,9,29,38,0.2812905987511576,Dovish
계획안/NNG,8,22,30,0.32959302479933617,Dovish
로보틱스/NNG,40,53,93,0.6840609948665468,Dovish
지낸/VV,19,24,43,0.7175514810735547,Dovish
선보였/VV,7,14,21,0.45319040909908725,Dovish
하향수/NNG,6,14,20,0.3884489220849319,Dovish
직원/NNG,241,328,569,0.6659688328834148,Dovish
운송업/NNG,12,17,29,0.639798224610476,Dovish
협의체/NNG,56,67,123,0.757572027150713,Dovish
원방/NNG,22,34,56,0.5864817058929364,Dovish
배가/NNG,8,11,19,0.6591860495986723,Dovish
대적/NNG,12,17,29,0.639798224610476,Dovish
물가/NNG;상승률/NNG;내리/VV,8,12,20,0.604253878798783,Dovish
아끼/VV,27,33,60,0.7415843057985064,Dovish
가리/VV,64,78,142,0.7436970815985021,Dovish
엄정/NNG,11,17,28,0.5864817058929364,Dovish
펀더멘털/NNG;악화/NNG,24,34,58,0.639798224610476,Dovish
공부/NNG,16,24,40,0.604253878798783,Dovish
물가/NNG;상승/NNG;경계/NNG,6,14,20,0.3884489220849319,Dovish
여름철/NNG,16,25,41,0.5800837236468316,Dovish
재판/NNG,35,51,86,0.6220260517046295,Dovish
텐트/NNG,18,64,82,0.2549196051182366,Dovish
지원금액/NNG,10,16,26,0.5664880113738591,Dovish
좋아하/VV,8,12,20,0.604253878798783,Dovish
대성/NNG,15,18,33,0.7553173484984786,Dovish
기여금/NNG,4,24,28,0.15106346969969575,Dovish
패러다임/NNG,30,42,72,0.6474148701415531,Dovish
집주인/NNG,9,15,24,0.5438284909189047,Dovish
중도상환수수료/NNG,20,29,49,0.6250902194470168,Dovish
선진국/NNG,1735,2220,3955,0.7083651889972219,Dovish
학력/NNG,16,21,37,0.6905758614843234,Dovish
가져와/VV,7,13,20,0.48805120979901695,Dovish
정형/NNG,8,10,18,0.7251046545585396,Dovish
유가/NNG;강세/NNG,12,17,29,0.639798224610476,Dovish
기준가격/NNG;하락/NNG,21,28,49,0.6797856136486309,Dovish
서플라이체인/NNG,9,12,21,0.6797856136486309,Dovish
숏베팅/NNG,8,14,22,0.5179318961132426,Dovish
양적/VAX;질적/VAX;금융/NNG;완화/NNG,6,11,17,0.49438953719900425,Dovish
청산/NNG,215,303,518,0.6431415046620709,Dovish
러스트벨트/NNG,6,13,19,0.4183296083991574,Dovish
상향/NNG;가능성/NNG;높/VA,16,22,38,0.6591860495986723,Dovish
달러원/NNG;연고점/NNG,10,16,26,0.5664880113738591,Dovish
셀프/NNG,6,13,19,0.4183296083991574,Dovish
장기추세선/NNG,15,19,34,0.715563803840664,Dovish
높/VA;경기/NNG;회복/NNG,7,13,20,0.48805120979901695,Dovish
계동/NNG,15,27,42,0.5035448989989858,Dovish
이어질까/VV,9,12,21,0.6797856136486309,Dovish
갈까/VV,10,18,28,0.5035448989989859,Dovish
부동산정보/NNG,8,12,20,0.604253878798783,Dovish
여력/NNG;줄/VV,8,15,23,0.4834031030390264,Dovish
단연/MAG,16,26,42,0.5577728111988766,Dovish
건재/NNG,12,17,29,0.639798224610476,Dovish
온화/NNG,15,22,37,0.6179869214987552,Dovish
특별참가자/NNG,1,17,18,0.053316518717539674,Dovish
전인대/NNG,17,54,71,0.2853421094327586,Dovish
손상차손/NNG,22,32,54,0.6231368125112449,Dovish
바이러스/NNG,129,170,299,0.6877830914562617,Dovish
고시/NNG,190,255,445,0.6753425704221693,Dovish
국채/NNG;금리/NNG;소폭/MAG;하락/NNG,7,11,18,0.5767877933988383,Dovish
수령/NNG,38,58,96,0.5938357084746659,Dovish
지브/NNG,21,31,52,0.6139999091019891,Dovish
인구증가율/NNG,14,19,33,0.6678595502512864,Dovish
중대/NNG,93,146,239,0.5773521650166453,Dovish
선다면/VV,5,12,17,0.3776586742492394,Dovish
상속세/NNG,20,49,69,0.36995135436660187,Dovish
풍성/NNG,3,15,18,0.1812761636396349,Dovish
충실/NNG,13,28,41,0.42081966559200956,Dovish
엿볼/VV,29,38,67,0.6917116770459752,Dovish
랩어카운트/NNG,3,20,23,0.13595712272972615,Dovish
해성/NNG,7,18,25,0.3524814292992901,Dovish
도시화/NNG,8,14,22,0.5179318961132426,Dovish
수요/NNG;악화/NNG,8,31,39,0.23390472727694822,Dovish
결정내용/NNG,12,79,91,0.1376780989668113,Dovish
부금/NNG,7,11,18,0.5767877933988383,Dovish
엄중/NNG,4,14,18,0.2589659480566213,Dovish
석화/NNG,22,28,50,0.7121563571557085,Dovish
취업자/NNG;증가/NNG,11,17,28,0.5864817058929364,Dovish
대차거래/NNG,18,28,46,0.5826733831273979,Dovish
호호/NNG,19,31,50,0.555523727282752,Dovish
레벨업/NNG,40,64,104,0.5664880113738591,Dovish
실적/NNG;회복/NNG;지연/NNG,5,12,17,0.3776586742492394,Dovish
국채/NNG;증가/NNG,9,11,20,0.7415843057985064,Dovish
기업/NNG;실적/NNG;저하/NNG,7,14,21,0.45319040909908725,Dovish
높/VA;고금리/NNG,12,16,28,0.6797856136486308,Dovish
담보자산/NNG,12,58,70,0.18752706583410503,Dovish
경기/NNG;약화/NNG,7,10,17,0.6344665727387221,Dovish
대대로/MAG,21,29,50,0.6563447304193677,Dovish
대형화/NNG,14,17,31,0.7464312620455553,Dovish
반감기/NNG,168,237,405,0.6424977951784527,Dovish
자보/NNG,12,26,38,0.4183296083991574,Dovish
경기민감주/NNG,13,20,33,0.5891475318288134,Dovish
휴전안/NNG,14,21,35,0.6042538787987829,Dovish
무역전쟁/NNG,74,138,212,0.48603029381641233,Dovish
非常/NNG,2,26,28,0.06972160139985957,Dovish
반드시/MAG,137,179,316,0.693710458620949,Dovish
금융투자업/NNG,6,32,38,0.1699464034121577,Dovish
해체/NNG,11,24,35,0.41542454167416326,Dovish
상호신용금고/NNG,7,16,23,0.3965416079617013,Dovish
전발/NNG,4,21,25,0.17264396537108084,Dovish
농후/NNG,10,12,22,0.7553173484984788,Dovish
액기/NNG,8,12,20,0.604253878798783,Dovish
인종/NNG,24,33,57,0.6591860495986723,Dovish
박재/NNG,1,25,26,0.036255232727926974,Dovish
신용/NNG;우려/NNG,8,14,22,0.5179318961132426,Dovish
대손비용/NNG;증가/NNG,15,22,37,0.6179869214987552,Dovish
환급금/NNG,5,14,19,0.32370743507077665,Dovish
수확/NNG,9,16,25,0.5098392102364732,Dovish
배신/NNG,5,14,19,0.32370743507077665,Dovish
아시/NNG,29,44,73,0.5973873574487969,Dovish
즐기/VV,15,37,52,0.36745168305331394,Dovish
선택권/NNG,9,16,25,0.5098392102364732,Dovish
비농업/NNG;고용/NNG;증가/NNG,67,125,192,0.48582011855422147,Dovish
고령/NNG,47,95,142,0.44841998374014946,Dovish
조달비중/NNG,41,87,128,0.42714498328879486,Dovish
갖춰진/VV,7,10,17,0.6344665727387221,Dovish
남겨둘/VV,6,13,19,0.4183296083991574,Dovish
crs/NNG,2455,2933,5388,0.758665158089505,Dovish
혁신당/NNG,23,50,73,0.41693517637116023,Dovish
본래/NNG,10,13,23,0.6972160139985957,Dovish
예상/NNG;금리/NNG;상승/NNG,9,12,21,0.6797856136486309,Dovish
수요/NNG;양호/NNG,5,12,17,0.3776586742492394,Dovish
도식/NNG,7,11,18,0.5767877933988383,Dovish
산소/NNG,10,20,30,0.45319040909908725,Dovish
태양/NNG,22,40,62,0.4985094500089959,Dovish
공산품/NNG,17,29,46,0.5313266865299643,Dovish
투자이익/NNG,20,38,58,0.47704253589377604,Dovish
어느새/MAG,6,16,22,0.3398928068243154,Dovish
종전/NNG,227,315,542,0.6531696689872559,Dovish
공영/NNG,16,25,41,0.5800837236468316,Dovish
대주단협약/NNG,17,37,54,0.4164452407937558,Dovish
폭풍/NNG,22,51,73,0.39098780392862426,Dovish
보금자리론/NNG,113,144,257,0.7112571698360675,Dovish
상세/NNG,66,82,148,0.7295260244034087,Dovish
당분간/MAG;완화/NNG,17,56,73,0.2751513198101601,Dovish
부인/NNG,70,118,188,0.537683536219256,Dovish
하락/NNG;그치/VV,9,17,26,0.47984866845785706,Dovish
강요/NNG,13,16,29,0.7364344147860167,Dovish
편중/NNG,30,42,72,0.6474148701415531,Dovish
이전/NNG;금리/NNG;인상/NNG,7,13,20,0.48805120979901695,Dovish
여론조사/NNG,92,133,225,0.62697019003182,Dovish
국채/NNG;금리/NNG;낮/VA,8,16,24,0.4531904090990872,Dovish
기축통화/NNG,46,65,111,0.6414387328787081,Dovish
장려/NNG,36,56,92,0.5826733831273979,Dovish
관관/NNG,262,372,634,0.6383649848600046,Dovish
이레/VV,13,20,33,0.5891475318288134,Dovish
개양/NNG,8,16,24,0.4531904090990872,Dovish
비전/NNG,80,104,184,0.6972160139985957,Dovish
연상/NNG,13,19,32,0.6201552966619088,Dovish
미학/NNG,12,49,61,0.22197081261996107,Dovish
리스트/NNG,107,148,255,0.6552888347784098,Dovish
특수목적법인/NNG,4,15,19,0.2417015515195132,Dovish
폭발/NNG,64,84,148,0.6905758614843234,Dovish
하락/NNG;원화/NNG;강세/NNG,7,13,20,0.48805120979901695,Dovish
불참/NNG,12,16,28,0.6797856136486308,Dovish
국제통화/NNG,5,30,35,0.15106346969969575,Dovish
병동/NNG,1,49,50,0.018497567718330093,Dovish
캡티브/NNG,47,93,140,0.45806342425069035,Dovish
기대/NNG;제한적/VAX,9,11,20,0.7415843057985064,Dovish
받아들여진다/VV,6,15,21,0.3625523272792698,Dovish
선박금융/NNG,4,14,18,0.2589659480566213,Dovish
기시/VV,8,14,22,0.5179318961132426,Dovish
나선다/VV,71,89,160,0.7230678437311279,Dovish
지적도/NNG,62,74,136,0.7594001449768488,Dovish
지수/NNG;부진/NNG,5,12,17,0.3776586742492394,Dovish
이젠/NNG,21,29,50,0.6563447304193677,Dovish
펀펀/MAG,57,102,159,0.5065069278166269,Dovish
헤지펀드/NNG,178,227,405,0.7107303332126654,Dovish
구체적/VAX,434,573,1007,0.6865083335043765,Dovish
금리/NNG;내리/VV;금리/NNG;내리/VV,7,17,24,0.37321563102277766,Dovish
긍긍/MAG,107,184,291,0.5270801497130688,Dovish
전성/NNG,11,19,30,0.5247467894831536,Dovish
분양권/NNG,6,17,23,0.319899112305238,Dovish
결제통화/NNG,7,14,21,0.45319040909908725,Dovish
내가격/NNG,8,13,21,0.5577728111988766,Dovish
고부가가치/NNG,14,22,36,0.5767877933988383,Dovish
소한/NNG,15,19,34,0.715563803840664,Dovish
산인/NNG,11,14,25,0.7121563571557085,Dovish
딩딩/MAG,22,49,71,0.406946489803262,Dovish
삼전/NNG,8,12,20,0.604253878798783,Dovish
국고채/NNG;금리/NNG;낮/VA,10,14,24,0.6474148701415533,Dovish
일본인/NNG,6,11,17,0.49438953719900425,Dovish
高原/NNG,2,45,47,0.040283591919918864,Dovish
부사장/NNG,25,75,100,0.3021269393993915,Dovish
기다/NNG,5,12,17,0.3776586742492394,Dovish
다림/NNG,4,51,55,0.07108869162338623,Dovish
단절/NNG,16,28,44,0.5179318961132426,Dovish
중소기업/NNG,776,967,1743,0.7273542036419683,Dovish
부진/NNG;면하/VV;못하/VX,12,19,31,0.5724510430725313,Dovish
패스/NNG,35,45,80,0.7049628585985801,Dovish
금융정책/NNG,80,133,213,0.545191469592887,Dovish
상용화/NNG,14,26,40,0.48805120979901695,Dovish
거친다/VV,8,20,28,0.3625523272792698,Dovish
투자수단/NNG,9,14,23,0.5826733831273979,Dovish
경제/NNG;완만/NNG;성장/NNG,8,13,21,0.5577728111988766,Dovish
부채/NNG;확대/NNG,13,16,29,0.7364344147860167,Dovish
사연/NNG,6,14,20,0.3884489220849319,Dovish
중단기물/NNG,78,133,211,0.5315616828530647,Dovish
금리/NNG;변동성/NNG;완화/NNG,8,17,25,0.4265321497403174,Dovish
글로벌/NNG;통화/NNG;완화/NNG,12,17,29,0.639798224610476,Dovish
바이트/NNG,16,25,41,0.5800837236468316,Dovish
속해/VV,23,31,54,0.6724760909212262,Dovish
갇혀/VV,15,28,43,0.4855611526061649,Dovish
밝혀왔/VV,10,16,26,0.5664880113738591,Dovish
잠재우/VV,12,22,34,0.49438953719900425,Dovish
라이더/NNG,27,46,73,0.5320061324206676,Dovish
출석/NNG,44,143,187,0.2788864055994383,Dovish
경합/NNG,26,73,99,0.3228205653856511,Dovish
돌려받/VV,15,19,34,0.715563803840664,Dovish
매출원가/NNG,6,23,29,0.23644716996474116,Dovish
국을/NNG,12,23,35,0.4728943399294823,Dovish
고배/NNG,9,32,41,0.2549196051182366,Dovish
취급비중/NNG,7,17,24,0.37321563102277766,Dovish
크레딧/NNG;투자심리/NNG;악화/NNG,7,11,18,0.5767877933988383,Dovish
국고채/NNG;스프레드/NNG;축소/NNG;압력/NNG,6,13,19,0.4183296083991574,Dovish
식형/NNG,8,23,31,0.31526289328632157,Dovish
제한적/VAX;상승/NNG,20,24,44,0.7553173484984788,Dovish
자금/NNG;수요/NNG;증가/NNG,11,16,27,0.6231368125112449,Dovish
해제/NNG,224,588,812,0.3452879307421617,Dovish
계량/NNG,18,33,51,0.4943895371990043,Dovish
장악/NNG,37,56,93,0.5988587548809367,Dovish
유로스타트/NNG,21,35,56,0.5438284909189046,Dovish
불안/NNG;완화/NNG,41,55,96,0.6756657008386391,Dovish
지표/NNG;안정/NNG,7,14,21,0.45319040909908725,Dovish
표상/NNG,5,18,23,0.25177244949949296,Dovish
경기/NNG;자신/NNG,17,23,40,0.6699336482334333,Dovish
양천/NNG,8,21,29,0.3452879307421617,Dovish
당당/NNG,7,14,21,0.45319040909908725,Dovish
보험권/NNG,60,82,142,0.6632054767303716,Dovish
증상/NNG,8,15,23,0.4834031030390264,Dovish
재정/NNG;적자/NNG;감축/NNG,7,10,17,0.6344665727387221,Dovish
가입/NNG,258,317,575,0.7376853346849496,Dovish
민정/NNG,8,20,28,0.3625523272792698,Dovish
ecb/NNG;통화정책/NNG;금리/NNG;인하/NNG,7,10,17,0.6344665727387221,Dovish
지수/NNG;소폭/MAG;하락/NNG,9,12,21,0.6797856136486309,Dovish
근본/NNG,34,49,83,0.6289173024232231,Dovish
융기/NNG,8,18,26,0.40283591919918865,Dovish
다툼/NNG,6,11,17,0.49438953719900425,Dovish
남발/NNG,7,10,17,0.6344665727387221,Dovish
단속/NNG,21,32,53,0.594812411942552,Dovish
성서/NNG,8,17,25,0.4265321497403174,Dovish
실내/NNG,8,19,27,0.38163402871502083,Dovish
버려야/VV,7,10,17,0.6344665727387221,Dovish
현금화/NNG,6,11,17,0.49438953719900425,Dovish
위험/NNG;피하/VV,7,10,17,0.6344665727387221,Dovish
개원/NNG,14,17,31,0.7464312620455553,Dovish
가짐/VV,9,14,23,0.5826733831273979,Dovish
키코/NNG,11,15,26,0.6646792666786613,Dovish
최남단/NNG,13,28,41,0.42081966559200956,Dovish
뉴욕이코노믹클럽/NNG,8,10,18,0.7251046545585396,Dovish
재정/NNG;건전성/NNG;회복/NNG,9,12,21,0.6797856136486309,Dovish
목격/NNG,28,35,63,0.7251046545585396,Dovish
파생결합사채/NNG,15,22,37,0.6179869214987552,Dovish
코루나/NNG,33,54,87,0.5538993888988845,Dovish
수입/NNG;물가/NNG;하락/NNG,7,15,22,0.42297771515914806,Dovish
연구개발/NNG,125,164,289,0.6908390382608036,Dovish
케이에스/NNG,8,26,34,0.2788864055994383,Dovish
트랙/NNG,13,23,36,0.5123022015902725,Dovish
수취/NNG,72,140,212,0.4661387065019183,Dovish
유족/NNG,5,13,18,0.34860800699929784,Dovish
타냈/VV,7,11,18,0.5767877933988383,Dovish
연장선/NNG,26,33,59,0.7141182203985617,Dovish
로스/NNG,5,14,19,0.32370743507077665,Dovish
내구성/NNG,5,17,22,0.26658259358769837,Dovish
포스/NNG,20,131,151,0.1383787508699503,Dovish
자자/NNG,154,194,348,0.7194981752707158,Dovish
행도/NNG,15,23,38,0.5911179249118529,Dovish
하락/NNG;반납/NNG,9,16,25,0.5098392102364732,Dovish
차압/NNG,7,20,27,0.31723328636936104,Dovish
투자심리/NNG;긍정적/VAX,17,24,41,0.6420197462237068,Dovish
종합무역법/NNG,7,13,20,0.48805120979901695,Dovish
대출비율/NNG,12,44,56,0.24719476859950212,Dovish
대잠/NNG,7,12,19,0.5287221439489351,Dovish
만기기준/NNG,14,19,33,0.6678595502512864,Dovish
통화정책/NNG;민감/NNG;금리/NNG;내리/VV,11,20,31,0.4985094500089959,Dovish
초월/NNG,4,22,26,0.16479651239966808,Dovish
벌어져/VV,30,40,70,0.6797856136486308,Dovish
소비/NNG;촉진/NNG,10,15,25,0.604253878798783,Dovish
부유층/NNG,6,11,17,0.49438953719900425,Dovish
불확실성/NNG;줄/VV,14,19,33,0.6678595502512864,Dovish
매입액/NNG,81,103,184,0.7127849152820596,Dovish
경제/NNG;성장/NNG;둔화/NNG,32,48,80,0.604253878798783,Dovish
광명/NNG,8,12,20,0.604253878798783,Dovish
심리/NNG;부담/NNG,15,18,33,0.7553173484984786,Dovish
계수/NNG,33,68,101,0.4398612794197023,Dovish
부티/NNG,3,33,36,0.08239825619983404,Dovish
곡동/NNG,7,16,23,0.3965416079617013,Dovish
규제당국/NNG,32,46,78,0.6305257865726431,Dovish
성층권/NNG,3,17,20,0.159949556152619,Dovish
결정권자/NNG,8,10,18,0.7251046545585396,Dovish
엄두/NNG,7,10,17,0.6344665727387221,Dovish
환전소/NNG,8,10,18,0.7251046545585396,Dovish
성탄절/NNG,3,16,19,0.1699464034121577,Dovish
안정성/NNG;높/VV,10,16,26,0.5664880113738591,Dovish
물러나/VV,24,30,54,0.7251046545585396,Dovish
공익/NNG,10,14,24,0.6474148701415533,Dovish
골자/NNG,52,73,125,0.6456411307713023,Dovish
단기자금시장/NNG;위축/NNG,8,10,18,0.7251046545585396,Dovish
전망/NNG;강세/NNG,17,30,47,0.5136157969789655,Dovish
주택가격/NNG;오름/NNG;둔화/NNG,5,12,17,0.3776586742492394,Dovish
직장인/NNG,9,20,29,0.4078713681891785,Dovish
국영/NNG,146,203,349,0.6518798002804604,Dovish
슬슬/MAG,7,16,23,0.3965416079617013,Dovish
모델포트폴리오/NNG,46,210,256,0.19854056017674296,Dovish
출산율/NNG,12,21,33,0.5179318961132425,Dovish
오너/NNG,5,20,25,0.22659520454954363,Dovish
사직서/NNG,2,16,18,0.1132976022747718,Dovish
순유입/NNG,308,502,810,0.5561061593725852,Dovish
통화/NNG;절상/NNG,7,13,20,0.48805120979901695,Dovish
전력공사/NNG,22,28,50,0.7121563571557085,Dovish
각국/NNG,385,501,886,0.6965201896333277,Dovish
거품/NNG,416,512,928,0.7364344147860167,Dovish
금융업계/NNG,11,14,25,0.7121563571557085,Dovish
주호/NNG,87,131,218,0.6019475662842838,Dovish
열린다/VV,33,48,81,0.623136812511245,Dovish
법원/NNG,103,125,228,0.7468577941952957,Dovish
안전장치/NNG,14,20,34,0.6344665727387221,Dovish
유럽연합/NNG,88,138,226,0.5779819710249228,Dovish
자임/NNG,6,11,17,0.49438953719900425,Dovish
물결/NNG,16,20,36,0.7251046545585396,Dovish
분할/NNG,86,147,233,0.5302636079254626,Dovish
명단/NNG,14,22,36,0.5767877933988383,Dovish
피해기업/NNG,8,13,21,0.5577728111988766,Dovish
부여/NNG,304,365,669,0.7549034759787534,Dovish
저평가/NNG,256,389,645,0.5964871194311894,Dovish
단기/NNG;금리/NNG;마이너스/NNG,5,19,24,0.23852126794688802,Dovish
금리/NNG;인상/NNG;금리/NNG;인하/NNG,12,19,31,0.5724510430725313,Dovish
채권/NNG;가격/NNG;상승/NNG,16,31,47,0.46780945455389644,Dovish
우에/MAG,44,92,136,0.4334864782686921,Dovish
인가/NNG,4,15,19,0.2417015515195132,Dovish
대내외/NNG;경제/NNG;여건/NNG;개선/NNG,9,13,22,0.6274944125987362,Dovish
윤곽/NNG,32,39,71,0.7436970815985021,Dovish
가운/NNG,65,79,144,0.7457563694035612,Dovish
정유소/NNG,10,21,31,0.4316099134277021,Dovish
학원/NNG,13,17,30,0.6931147433280157,Dovish
놓였/VV,5,17,22,0.26658259358769837,Dovish
보일지/VV,13,20,33,0.5891475318288134,Dovish
물가/NNG;상승률/NNG;전망/NNG;하향/NNG,8,11,19,0.6591860495986723,Dovish
부트/NNG,22,62,84,0.3216190000058038,Dovish
흑자국/NNG,12,16,28,0.6797856136486308,Dovish
우려/NNG;증폭/NNG,9,18,27,0.45319040909908725,Dovish
외국기업/NNG,10,19,29,0.47704253589377604,Dovish
디레버리지/NNG,17,21,38,0.7337368528270936,Dovish
금리/NNG;인하/NNG;압력/NNG,10,15,25,0.604253878798783,Dovish
선거비용/NNG,3,14,17,0.19422446104246596,Dovish
신용/NNG;확대/NNG,9,12,21,0.6797856136486309,Dovish
스왑베이시스/NNG,185,221,406,0.7587350740572953,Dovish
운용사/NNG,169,216,385,0.7091590660902384,Dovish
분양보증/NNG,7,17,24,0.37321563102277766,Dovish
도덕적해이/NNG,26,42,68,0.5610928874560127,Dovish
개편/NNG,187,249,436,0.6806956345504362,Dovish
워크/NNG,16,26,42,0.5577728111988766,Dovish
마두/NNG,7,16,23,0.3965416079617013,Dovish
증권화/NNG,10,15,25,0.604253878798783,Dovish
찰찰찰/MAG,6,16,22,0.3398928068243154,Dovish
서초/NNG,24,50,74,0.4350627927351237,Dovish
금리/NNG;깜짝/MAG;인하/NNG,3,22,25,0.12359738429975106,Dovish
약간/NNG,122,157,279,0.7043214001285177,Dovish
기세/NNG,20,31,51,0.5847618181923706,Dovish
비상계획/NNG,6,13,19,0.4183296083991574,Dovish
선주/NNG,9,15,24,0.5438284909189047,Dovish
자본총계/NNG,41,52,93,0.7146464143485606,Dovish
상증/NNG,7,19,26,0.3339297751256432,Dovish
판결/NNG,52,82,134,0.5747780798329887,Dovish
명확히/MAG,75,95,170,0.715563803840664,Dovish
공모발행/NNG,16,24,40,0.604253878798783,Dovish
심상/NNG;않/VX,20,27,47,0.6713931986653144,Dovish
금리/NNG;인하/NNG;기대/NNG;강세/NNG,9,15,24,0.5438284909189047,Dovish
공작/NNG,6,13,19,0.4183296083991574,Dovish
행동주의/NNG,38,73,111,0.4718146724867209,Dovish
빌리지/NNG,3,21,24,0.12948297402831063,Dovish
crs/NNG;금리/NNG;하락/NNG,11,16,27,0.6231368125112449,Dovish
기반시설/NNG,13,29,42,0.40630864264056094,Dovish
fed/NNG;양적완화/NNG;축소/NNG,7,12,19,0.5287221439489351,Dovish
경제활동인구/NNG,36,58,94,0.5625811975023152,Dovish
숨겨진/VV,9,39,48,0.20916480419957872,Dovish
눈여겨볼/VV,13,23,36,0.5123022015902725,Dovish
飛上/NNG,1,26,27,0.034860800699929785,Dovish
수산금융채권/NNG,16,27,43,0.5371145589322516,Dovish
빌미/NNG,30,54,84,0.5035448989989858,Dovish
의대/NNG,91,159,250,0.5187462544404646,Dovish
환경/NNG;우호적/VAX,8,12,20,0.604253878798783,Dovish
세탁기/NNG,5,14,19,0.32370743507077665,Dovish
하락/NNG;둔화/NNG,14,18,32,0.7049628585985802,Dovish
동일/NNG,883,1139,2022,0.702663970561008,Dovish
코퍼레이션/NNG,192,314,506,0.5542201181339155,Dovish
탑승/NNG,10,12,22,0.7553173484984788,Dovish
상계/NNG,21,32,53,0.594812411942552,Dovish
수혜주/NNG,15,24,39,0.566488011373859,Dovish
아르누보/NNG,7,12,19,0.5287221439489351,Dovish
특은/NNG,36,48,84,0.6797856136486309,Dovish
비견/NNG,8,10,18,0.7251046545585396,Dovish
반비례/NNG,10,13,23,0.6972160139985957,Dovish
예상/NNG;fed/NNG;금리/NNG;인상/NNG,8,10,18,0.7251046545585396,Dovish
재계/NNG,23,31,54,0.6724760909212262,Dovish
역rp/NNG,75,99,174,0.6866521349986171,Dovish
분포/NNG,139,192,331,0.6561819465080534,Dovish
놓일/VV,9,13,22,0.6274944125987362,Dovish
크림/NNG,9,26,35,0.3137472062993681,Dovish
국한/NNG,210,272,482,0.6997793081677082,Dovish
경제/NNG;위험/NNG,11,20,31,0.4985094500089959,Dovish
닛케이/NNG,528,788,1316,0.6073211573713657,Dovish
부채/NNG;우려/NNG,9,12,21,0.6797856136486309,Dovish
유통수익률/NNG,13,18,31,0.6546083686986816,Dovish
원자/NNG,11,29,40,0.34379962069585923,Dovish
제조업/NNG;둔화/NNG,8,10,18,0.7251046545585396,Dovish
미확정/NNG,25,31,56,0.7309522727404633,Dovish
메커니즘/NNG,75,92,167,0.7388974061398161,Dovish
들여다보/VV,24,31,55,0.7017141818308447,Dovish
후생/NNG,8,17,25,0.4265321497403174,Dovish
접근방법/NNG,41,75,116,0.495488180615002,Dovish
gdp/NNG;갭/NNG;마이너스/NNG,12,17,29,0.639798224610476,Dovish
무역금융/NNG,13,25,38,0.4713180254630507,Dovish
입회장/NNG,7,52,59,0.12201280244975424,Dovish
로지스틱스/NNG,42,60,102,0.6344665727387221,Dovish
건립/NNG,9,13,22,0.6274944125987362,Dovish
아스/VV,12,16,28,0.6797856136486308,Dovish
체납/NNG,11,29,40,0.34379962069585923,Dovish
금융계정/NNG,15,18,33,0.7553173484984786,Dovish
단기/NNG;금리/NNG;상승/NNG;압력/NNG,10,12,22,0.7553173484984788,Dovish
테마주/NNG,9,14,23,0.5826733831273979,Dovish
일수/NNG,12,27,39,0.40283591919918865,Dovish
실적/NNG;회복/NNG,46,55,101,0.7580639570384732,Dovish
도시개발공사/NNG,41,62,103,0.5993808636471798,Dovish
경영권/NNG,43,76,119,0.5128207260858093,Dovish
부실채권/NNG;증가/NNG,7,10,17,0.6344665727387221,Dovish
중도환매/NNG,10,19,29,0.47704253589377604,Dovish
버리/VV,24,30,54,0.7251046545585396,Dovish
범용/NNG,6,14,20,0.3884489220849319,Dovish
실업률/NNG;증가/NNG,18,22,40,0.7415843057985064,Dovish
경제/NNG;지표/NNG;개선/NNG,43,56,99,0.6959709854021697,Dovish
책방/NNG,24,40,64,0.5438284909189046,Dovish
최대/NNG;하락/NNG,17,27,44,0.5706842188655172,Dovish
금리/NNG;우호적/VAX,17,27,44,0.5706842188655172,Dovish
도루/NNG,8,16,24,0.4531904090990872,Dovish
신문사/NNG,7,10,17,0.6344665727387221,Dovish
샤프/NNG,6,25,31,0.21753139636756186,Dovish
새해/NNG,49,64,113,0.6939478139329773,Dovish
준호/NNG,9,14,23,0.5826733831273979,Dovish
결제비중/NNG,8,10,18,0.7251046545585396,Dovish
지배력/NNG,17,21,38,0.7337368528270936,Dovish
일조/NNG,100,133,233,0.6814893369911087,Dovish
에세이/NNG,1,20,21,0.04531904090990872,Dovish
비핵화/NNG,14,22,36,0.5767877933988383,Dovish
대형기업/NNG,19,23,42,0.7487493715550136,Dovish
퇴출/NNG,41,74,115,0.502183966839529,Dovish
불꽃/NNG,10,23,33,0.39407861660790194,Dovish
급락장/NNG,5,13,18,0.34860800699929784,Dovish
채권선물/NNG,11,23,34,0.4334864782686921,Dovish
공국/NNG,6,14,20,0.3884489220849319,Dovish
레인지장세/NNG,24,35,59,0.621518275335891,Dovish
위기극복/NNG,28,34,62,0.7464312620455553,Dovish
자사/NNG,57,72,129,0.7175514810735548,Dovish
구인배율/NNG,7,18,25,0.3524814292992901,Dovish
끼친/VV,16,24,40,0.604253878798783,Dovish
금리/NNG;인하/NNG;경기/NNG;부양/NNG,12,20,32,0.5438284909189046,Dovish
영문/NNG,6,12,18,0.4531904090990872,Dovish
장점/NNG,99,124,223,0.7236427500130586,Dovish
날짜/NNG,144,172,316,0.7588304524449833,Dovish
갱신/NNG,86,133,219,0.5860808298123534,Dovish
조례/NNG,8,14,22,0.5179318961132426,Dovish
내세웠/VV,22,34,56,0.5864817058929364,Dovish
디지털화/NNG,11,14,25,0.7121563571557085,Dovish
문서/NNG,11,24,35,0.41542454167416326,Dovish
신세/NNG,10,18,28,0.5035448989989859,Dovish
부채/NNG;축소/NNG,9,17,26,0.47984866845785706,Dovish
심리/NNG;살/VV,13,16,29,0.7364344147860167,Dovish
중앙정부/NNG,61,74,135,0.7471517555417384,Dovish
광해/NNG,19,30,49,0.5740411848588438,Dovish
유동성/NNG;높/VA,8,14,22,0.5179318961132426,Dovish
여겨진다/VV,32,47,79,0.61711034430514,Dovish
모방/NNG,7,22,29,0.28839389669941917,Dovish
헤드/NNG,70,88,158,0.7209847417485479,Dovish
위험/NNG;선호/NNG;확산/NNG,5,12,17,0.3776586742492394,Dovish
던진/VV,9,12,21,0.6797856136486309,Dovish
경기/NNG;나쁘/VA,7,14,21,0.45319040909908725,Dovish
조급/NNG,9,12,21,0.6797856136486309,Dovish
일비/NNG,539,647,1186,0.7550838655468562,Dovish
수소/NNG,70,209,279,0.30357252284149383,Dovish
기울여/VV,9,13,22,0.6274944125987362,Dovish
예상/NNG;늦/VA,8,13,21,0.5577728111988766,Dovish
환헤지ㅇ/NNG,80,171,251,0.42403780968335647,Dovish
수출품/NNG,15,23,38,0.5911179249118529,Dovish
로직/NNG,21,29,50,0.6563447304193677,Dovish
콜차입/NNG,18,23,41,0.7093415098942235,Dovish
세후/NNG,10,17,27,0.5331651871753967,Dovish
기조연설/NNG,6,29,35,0.18752706583410503,Dovish
대미/NNG,99,142,241,0.631913387335347,Dovish
상하향/NNG,24,59,83,0.3686972819789184,Dovish
회색코뿔소/NNG,7,39,46,0.16268373659967234,Dovish
우월/NNG,17,42,59,0.3668684264135468,Dovish
금융기업/NNG,64,149,213,0.38931793533344405,Dovish
감가상각/NNG,12,19,31,0.5724510430725313,Dovish
인플레이션/NNG;넘/VV,7,12,19,0.5287221439489351,Dovish
착실히/MAG,3,14,17,0.19422446104246596,Dovish
퇴장/NNG,8,18,26,0.40283591919918865,Dovish
앞서/MAG,605,722,1327,0.7595019321466697,Dovish
대준/NNG,8,16,24,0.4531904090990872,Dovish
주도주/NNG,11,24,35,0.41542454167416326,Dovish
톡톡히/MAG,18,24,42,0.6797856136486309,Dovish
위쪽/NNG,34,48,82,0.6420197462237068,Dovish
한지/NNG,15,23,38,0.5911179249118529,Dovish
국채입찰/NNG;강하/VA,8,17,25,0.4265321497403174,Dovish
년차/NNG,6,17,23,0.319899112305238,Dovish
낮/VA;인플레이션/NNG;압력/NNG,8,15,23,0.4834031030390264,Dovish
비화/NNG,21,27,48,0.7049628585985801,Dovish
인해서/VV,33,43,76,0.6955945814079014,Dovish
주관적/VAX,9,12,21,0.6797856136486309,Dovish
극적/VAX,37,65,102,0.5159398503589608,Dovish
규제안/NNG,31,44,75,0.6385864855487138,Dovish
뛰어들/VV,17,29,46,0.5313266865299643,Dovish
파생시장/NNG,18,33,51,0.4943895371990043,Dovish
불공정거래/NNG,4,14,18,0.2589659480566213,Dovish
인터넷은행/NNG,23,38,61,0.5485989162778424,Dovish
크레딧/NNG;비중/NNG;확대/NNG,9,12,21,0.6797856136486309,Dovish
이른다/VV,27,46,73,0.5320061324206676,Dovish
다발/NNG,20,35,55,0.5179318961132425,Dovish
대입법/NNG,6,16,22,0.3398928068243154,Dovish
거래주체/NNG,62,122,184,0.4606197600679247,Dovish
일정표/NNG,4,14,18,0.2589659480566213,Dovish
알린다/VV,6,19,25,0.2862255215362656,Dovish
보험업/NNG,76,92,168,0.7487493715550136,Dovish
필라델피아반도체지수/NNG;하락/NNG,11,17,28,0.5864817058929364,Dovish
양육비/NNG,3,23,26,0.11822358498237058,Dovish
슈슈/NNG,14,23,37,0.5517100632510628,Dovish
사회적책임/NNG,8,14,22,0.5179318961132426,Dovish
내수산업/NNG,10,18,28,0.5035448989989859,Dovish
극도/NNG,51,67,118,0.6899316675836851,Dovish
소식통/NNG,22,48,70,0.41542454167416326,Dovish
조루/NNG,9,14,23,0.5826733831273979,Dovish
되돌아가/VV,5,20,25,0.22659520454954363,Dovish
준수/NNG,94,125,219,0.6815983752850272,Dovish
근방/NNG,10,30,40,0.3021269393993915,Dovish
풍부/NNG,517,619,1136,0.7570256591412863,Dovish
산매/NNG,20,28,48,0.6474148701415533,Dovish
국영기업/NNG,24,34,58,0.639798224610476,Dovish
고금/NNG,8,10,18,0.7251046545585396,Dovish
지표/NNG;금리/NNG;상승/NNG,21,28,49,0.6797856136486309,Dovish
개편안/NNG,15,48,63,0.2832440056869295,Dovish
보유자산/NNG,210,253,463,0.7523319044332674,Dovish
상환/NNG;부담/NNG,8,13,21,0.5577728111988766,Dovish
승진/NNG,9,28,37,0.29133669156369896,Dovish
인과관계/NNG,15,34,49,0.39987389038154747,Dovish
꿈틀/MAG,7,10,17,0.6344665727387221,Dovish
필수소비재/NNG,188,245,433,0.6955085462092114,Dovish
토신/NNG,3,20,23,0.13595712272972615,Dovish
발행시장/NNG;강세/NNG,36,45,81,0.7251046545585396,Dovish
사모발행/NNG,9,17,26,0.47984866845785706,Dovish
탁탁탁/MAG,3,16,19,0.1699464034121577,Dovish
전폭/NNG,4,27,31,0.1342786397330629,Dovish
경제/NNG;완만/NNG;회복/NNG,13,25,38,0.4713180254630507,Dovish
손상/NNG,41,61,102,0.6092067794446746,Dovish
오일/NNG,49,65,114,0.6832716937186238,Dovish
급진/NNG,25,32,57,0.7081100142173238,Dovish
저축은행사태/NNG,13,21,34,0.5610928874560127,Dovish
신용보증/NNG,56,77,133,0.6591860495986723,Dovish
실효/NNG,163,282,445,0.5239009693840512,Dovish
노이즈/NNG,120,151,271,0.7203026369786816,Dovish
개조/NNG,7,14,21,0.45319040909908725,Dovish
저평가/NNG;해소/NNG,10,14,24,0.6474148701415533,Dovish
모을/VV,4,21,25,0.17264396537108084,Dovish
열흘/NNG,12,16,28,0.6797856136486308,Dovish
실업률/NNG;높/VA,16,34,50,0.4265321497403174,Dovish
토론회/NNG,77,106,183,0.6584087075590512,Dovish
내성/NNG,13,16,29,0.7364344147860167,Dovish
월세/NNG,54,102,156,0.47984866845785706,Dovish
경기/NNG;모멘텀/NNG,20,26,46,0.6972160139985957,Dovish
콜라/NNG,14,17,31,0.7464312620455553,Dovish
무제한/NNG,86,192,278,0.40598307481793233,Dovish
전공/NNG,71,91,162,0.7071762427700041,Dovish
되돌림현상/NNG,15,23,38,0.5911179249118529,Dovish
투자기회/NNG,64,82,146,0.707419175179063,Dovish
휴직자/NNG,3,16,19,0.1699464034121577,Dovish
언제/MAG;금리/NNG;인하/NNG,12,20,32,0.5438284909189046,Dovish
금리/NNG;완화/NNG,17,23,40,0.6699336482334333,Dovish
페달/NNG,8,11,19,0.6591860495986723,Dovish
국태/NNG,52,81,133,0.5818741055099391,Dovish
입량/NNG,5,42,47,0.10790247835692553,Dovish
모순/NNG,15,32,47,0.42486600853039425,Dovish
블로그/NNG,16,24,40,0.604253878798783,Dovish
차익매물/NNG,31,38,69,0.7394159306353528,Dovish
전망/NNG;확산/NNG,25,39,64,0.5810133449988297,Dovish
영업이익/NNG;증가/NNG,21,31,52,0.6139999091019891,Dovish
바이/NNG,30,38,68,0.715563803840664,Dovish
두려워하/VV,7,12,19,0.5287221439489351,Dovish
경기/NNG;활성화/NNG,18,22,40,0.7415843057985064,Dovish
대사/NNG,29,37,66,0.710406587236407,Dovish
내연/NNG,4,21,25,0.17264396537108084,Dovish
금리/NNG;떨어/VV,22,37,59,0.5389291351448604,Dovish
태시/NNG,7,11,18,0.5767877933988383,Dovish
로즈/NNG,8,11,19,0.6591860495986723,Dovish
신신/MAG,147,182,329,0.7320768146985255,Dovish
등급평정/NNG,4,19,23,0.19081701435751042,Dovish
그날/NNG,5,14,19,0.32370743507077665,Dovish
기업가치/NNG,69,135,204,0.46326130707906693,Dovish
지준부리/NNG,18,37,55,0.4409420196639768,Dovish
미니/NNG,36,47,83,0.6942491373432825,Dovish
국제/NNG;금융시장/NNG;안정/NNG,12,21,33,0.5179318961132425,Dovish
추첨/NNG,14,37,51,0.34295490418309305,Dovish
걸림돌/NNG,70,107,177,0.5929594137745067,Dovish
상승곡선/NNG,7,10,17,0.6344665727387221,Dovish
성장/NNG;전환/NNG,7,13,20,0.48805120979901695,Dovish
채권시장/NNG;견조/NNG,10,12,22,0.7553173484984788,Dovish
혼합/NNG,270,475,745,0.5152059387652781,Dovish
노릇/NNG,12,22,34,0.49438953719900425,Dovish
오릭스/NNG,12,20,32,0.5438284909189046,Dovish
비영리단체/NNG,7,18,25,0.3524814292992901,Dovish
저소득층/NNG,75,106,181,0.6413071826873876,Dovish
휴가/NNG,72,89,161,0.733251897868186,Dovish
스몰딜/NNG,7,10,17,0.6344665727387221,Dovish
금리/NNG;변동성/NNG;높/VA,18,25,43,0.6525941891026856,Dovish
하한/NNG,67,162,229,0.3748612025881339,Dovish
역마/NNG,7,12,19,0.5287221439489351,Dovish
금리/NNG;인상/NNG;쉽/VA;않/VX,8,10,18,0.7251046545585396,Dovish
금리/NNG;인하/NNG;그치/VV,20,29,49,0.6250902194470168,Dovish
배려/NNG,12,31,43,0.35085709091542233,Dovish
부치/VV,8,16,24,0.4531904090990872,Dovish
구름/NNG,18,22,40,0.7415843057985064,Dovish
노비/NNG,13,17,30,0.6931147433280157,Dovish
헤알/NNG,882,1088,1970,0.7347682735760935,Dovish
장담/NNG,37,78,115,0.429949875299134,Dovish
충충충/MAG,18,23,41,0.7093415098942235,Dovish
나타났으나/VV,25,30,55,0.7553173484984788,Dovish
철폐/NNG,52,106,158,0.44463964666325534,Dovish
하락/NNG;강세/NNG,9,11,20,0.7415843057985064,Dovish
정대/NNG,7,20,27,0.31723328636936104,Dovish
특례시/NNG,7,18,25,0.3524814292992901,Dovish
차갑/VA,23,41,64,0.5084575321599516,Dovish
용기/NNG,15,25,40,0.5438284909189046,Dovish
항구/NNG,29,39,68,0.6739754801986425,Dovish
좁혔/VV,23,42,65,0.49635140044185744,Dovish
전당/NNG,22,32,54,0.6231368125112449,Dovish
행정지도/NNG,7,21,28,0.30212693939939145,Dovish
금융시장/NNG;부정적/VAX,9,18,27,0.45319040909908725,Dovish
탈피/NNG,108,163,271,0.6005467997877475,Dovish
모색/NNG,163,198,361,0.7461619866984972,Dovish
지표/NNG;완화/NNG,21,26,47,0.7320768146985255,Dovish
왕좌/NNG,1,25,26,0.036255232727926974,Dovish
fed/NNG;부담/NNG,10,12,22,0.7553173484984788,Dovish
물동량/NNG,10,13,23,0.6972160139985957,Dovish
업황/NNG;개선/NNG,42,53,95,0.718264044609874,Dovish
우한/NNG,5,49,54,0.09248783859165047,Dovish
증권거래소/NNG,19,45,64,0.3826941232392292,Dovish
농도/NNG,5,13,18,0.34860800699929784,Dovish
모집주선/NNG,10,18,28,0.5035448989989859,Dovish
시정/NNG,20,35,55,0.5179318961132425,Dovish
특약/NNG,2,20,22,0.09063808181981745,Dovish
연합회/NNG,47,63,110,0.6761888643700666,Dovish
집단행동/NNG,22,28,50,0.7121563571557085,Dovish
채권/NNG;금리/NNG;약세/NNG,9,14,23,0.5826733831273979,Dovish
화약/NNG,10,14,24,0.6474148701415533,Dovish
솔솔/MAG,26,42,68,0.5610928874560127,Dovish
임대차/NNG,30,88,118,0.3089934607493776,Dovish
중상위/NNG,8,12,20,0.604253878798783,Dovish
지수/NNG;저점/NNG,8,12,20,0.604253878798783,Dovish
이룬다/VV,8,13,21,0.5577728111988766,Dovish
기간산업/NNG,31,52,83,0.5403424108489117,Dovish
성장/NNG;높/VA,8,17,25,0.4265321497403174,Dovish
부채비율/NNG;낮/VV,8,15,23,0.4834031030390264,Dovish
개혁/NNG,483,631,1114,0.6937907055304569,Dovish
서브프라임/NNG,33,43,76,0.6955945814079014,Dovish
강의/NNG,8,15,23,0.4834031030390264,Dovish
불량/NNG,9,16,25,0.5098392102364732,Dovish
비농업/NNG;고용/NNG;호조/NNG,6,11,17,0.49438953719900425,Dovish
할부리스사/NNG,4,13,17,0.2788864055994383,Dovish
외부감사/NNG,9,16,25,0.5098392102364732,Dovish
아베노믹스/NNG,45,98,143,0.41619527366242703,Dovish
분할상환대출/NNG,5,24,29,0.1888293371246197,Dovish
물가/NNG;지표/NNG;부진/NNG,7,10,17,0.6344665727387221,Dovish
피탈/NNG,5,12,17,0.3776586742492394,Dovish
