word,up,down,total,polar_score,polarity
경기/NNG;침체/NNG;우려/NNG;확대/NNG,20,7,27,2.589659480566213,Hawkish
캥거루본드/NNG,24,1,25,21.753139636756185,Hawkish
병목/NNG,58,22,80,2.3895494297951876,Hawkish
인플레이션/NNG;금리/NNG;인하/NNG,24,15,39,1.4502093091170791,Hawkish
국고채/NNG;입찰/NNG;호조/NNG,22,11,33,1.8127616363963488,Hawkish
순유입액/NNG,24,12,36,1.8127616363963488,Hawkish
기대/NNG;밑돌/VV,13,7,20,1.6832786623680382,Hawkish
스태그플레이션/NNG,361,137,498,2.3883465355440947,Hawkish
수출/NNG;호조/NNG,101,52,153,1.760470435346454,Hawkish
사회주의/NNG,13,6,19,1.9638251060960445,Hawkish
현주소/NNG,13,9,22,1.309216737397363,Hawkish
위험/NNG;높/VV,29,18,47,1.460280207097059,Hawkish
구하/VV,53,36,89,1.3343939823473125,Hawkish
건설/NNG;투자/NNG;회복/NNG,13,7,20,1.6832786623680382,Hawkish
더디/VV,41,27,68,1.3763560572638944,Hawkish
인플레이션/NNG;물가/NNG;상승/NNG;압력/NNG,13,8,21,1.4728688295720334,Hawkish
설날/NNG,17,8,25,1.9260592386711206,Hawkish
부동산/NNG;경기/NNG;둔화/NNG,35,19,54,1.6696488756282162,Hawkish
학군/NNG,15,6,21,2.265952045495436,Hawkish
양호/NNG;성장/NNG,55,38,93,1.311866973707884,Hawkish
연체율/NNG;높/VA,16,10,26,1.4502093091170791,Hawkish
격변/NNG,18,7,25,2.3306935325095917,Hawkish
봉쇄/NNG,238,110,348,1.9610784975560502,Hawkish
인상/NNG;선호/NNG,16,8,24,1.8127616363963488,Hawkish
공동선언문/NNG,52,4,56,11.782950636576267,Hawkish
닉스/NNG,34,22,56,1.4007703553971786,Hawkish
대면/NNG,62,35,97,1.6055888779510519,Hawkish
양수/NNG,41,21,62,1.7696006450535784,Hawkish
경기/NNG;하방/NNG;위험/NNG;확대/NNG,21,8,29,2.379249647770208,Hawkish
대입/NNG,49,33,82,1.3458381845972893,Hawkish
할인채/NNG,155,89,244,1.5785283912440116,Hawkish
이이/NNG,14,5,19,2.5378662909548884,Hawkish
말일/NNG,18,12,30,1.3595712272972618,Hawkish
국채/NNG;입찰/NNG;호조/NNG,18,2,20,8.15742736378357,Hawkish
듀레이션갭/NNG,13,9,22,1.309216737397363,Hawkish
월보/NNG,52,35,87,1.3466229298944306,Hawkish
첨단산업/NNG,16,6,22,2.417015515195132,Hawkish
인하/NNG;지연/NNG,26,13,39,1.8127616363963488,Hawkish
질질/MAG,177,117,294,1.3711914941972383,Hawkish
대출태도/NNG,396,186,582,1.929714000034823,Hawkish
금리/NNG;인하/NNG;경계/NNG,25,13,38,1.7430400349964892,Hawkish
예상/NNG;높/VA,174,121,295,1.3033905980701022,Hawkish
만한/NNG,49,33,82,1.3458381845972893,Hawkish
창의/NNG,13,8,21,1.4728688295720334,Hawkish
행지/NNG,29,18,47,1.460280207097059,Hawkish
gdp/NNG;부진/NNG,21,12,33,1.5861664318468052,Hawkish
국제/NNG;유가/NNG;급등/NNG,52,30,82,1.5710600848768357,Hawkish
상방/NNG;위험/NNG;크/VV,15,3,18,4.531904090990872,Hawkish
두렵/VA,33,23,56,1.3004594348060765,Hawkish
생산설비/NNG,46,29,75,1.4377075047281387,Hawkish
연대채무/NNG,19,1,20,17.221235545765314,Hawkish
꺼리/VV,32,22,54,1.3183720991973447,Hawkish
변신/NNG,16,8,24,1.8127616363963488,Hawkish
따라오/VV,14,4,18,3.1723328636936103,Hawkish
보보/NNG,226,113,339,1.8127616363963486,Hawkish
천명/NNG,28,19,47,1.3357191005025728,Hawkish
대출/NNG;소폭/MAG;증가/NNG,37,11,48,3.0487354793938595,Hawkish
수요/NNG;충족/NNG,20,13,33,1.3944320279971913,Hawkish
법정최고금리/NNG,13,9,22,1.309216737397363,Hawkish
근원/NNG;물가/NNG;하락/NNG,24,12,36,1.8127616363963488,Hawkish
빈일자리/NNG,59,16,75,3.342279267105768,Hawkish
가공/NNG,67,39,106,1.5571157645968636,Hawkish
막연/NNG,28,18,46,1.4099257171971604,Hawkish
관성/NNG,44,17,61,2.3459268235717454,Hawkish
긴축/NNG;위험/NNG,15,10,25,1.3595712272972615,Hawkish
기지/NNG,76,49,125,1.4058151465930868,Hawkish
전망/NNG;침체/NNG,15,3,18,4.531904090990872,Hawkish
위원수/NNG,26,14,40,1.6832786623680382,Hawkish
채광/NNG,11,7,18,1.424312714311417,Hawkish
경과/NNG,130,87,217,1.3543621421352032,Hawkish
마진/NNG;축소/NNG,18,11,29,1.4831686115970129,Hawkish
성장/NNG;추세/NNG,23,16,39,1.3029224261598757,Hawkish
경제/NNG;성장/NNG;개선/NNG,24,10,34,2.1753139636756185,Hawkish
구주/NNG,19,11,30,1.5655668677968468,Hawkish
적립식/NNG,20,13,33,1.3944320279971913,Hawkish
메사/NNG,14,6,20,2.1148885757957405,Hawkish
대북/NNG,68,23,91,2.679734592933733,Hawkish
인도분/NNG,200,99,299,1.8310723599963121,Hawkish
공매도/NNG,101,50,151,1.8308892527603122,Hawkish
후행/NNG,278,158,436,1.594771313032231,Hawkish
노동시장/NNG;둔화/NNG,22,13,35,1.5338752307969103,Hawkish
표수/NNG,16,7,23,2.0717275844529706,Hawkish
상승률/NNG;둔화/NNG,49,30,79,1.4804220030570183,Hawkish
오프닝/NNG,120,80,200,1.3595712272972615,Hawkish
인플레이션/NNG;고점/NNG,15,8,23,1.699464034121577,Hawkish
순포지션/NNG,139,21,160,5.999377796645059,Hawkish
축기/NNG,18,3,21,5.438284909189047,Hawkish
레이더/NNG,16,7,23,2.0717275844529706,Hawkish
산업혁명/NNG,12,6,18,1.8127616363963488,Hawkish
인플레이션/NNG;압력/NNG;높/VV,12,7,19,1.5537956883397277,Hawkish
기온/NNG,71,44,115,1.462569047547054,Hawkish
공급/NNG;압력/NNG,13,6,19,1.9638251060960445,Hawkish
커지/NNG,14,9,23,1.4099257171971604,Hawkish
롤링/NNG,16,9,25,1.6113436767967546,Hawkish
농지/NNG,28,6,34,4.229777151591481,Hawkish
멈춰/VV,26,17,43,1.3862294866560314,Hawkish
유해/NNG,13,8,21,1.4728688295720334,Hawkish
새새/NNG,14,9,23,1.4099257171971604,Hawkish
면면/NNG,457,232,689,1.7854139392955417,Hawkish
산지/NNG,19,4,23,4.3053088864413285,Hawkish
난망/NNG,17,10,27,1.5408473909368965,Hawkish
유가/NNG;상승/NNG,195,120,315,1.4728688295720336,Hawkish
직원수/NNG,24,5,29,4.350627927351237,Hawkish
한번/MAG,56,32,88,1.5861664318468052,Hawkish
통화유통속도/NNG,36,6,42,5.438284909189047,Hawkish
시장원리/NNG,19,5,24,3.444247109153063,Hawkish
안건/NNG,70,35,105,1.8127616363963488,Hawkish
소집/NNG,39,23,62,1.5369066047708175,Hawkish
보편/NNG,28,18,46,1.4099257171971604,Hawkish
손익/NNG,442,298,740,1.344363495448299,Hawkish
비관주의/NNG,48,1,49,43.50627927351237,Hawkish
소비/NNG;여력/NNG;감소/NNG,11,7,18,1.424312714311417,Hawkish
가근/NNG,40,16,56,2.2659520454954363,Hawkish
비상금/NNG,16,5,21,2.9004186182341583,Hawkish
금리/NNG;성장/NNG,15,6,21,2.265952045495436,Hawkish
금융시장/NNG;완화/NNG,17,10,27,1.5408473909368965,Hawkish
수요/NNG;둔화/NNG,129,60,189,1.948718759126075,Hawkish
척결/NNG,15,8,23,1.699464034121577,Hawkish
효력/NNG,29,18,47,1.460280207097059,Hawkish
영주/NNG,240,73,313,2.979882142021395,Hawkish
고용/NNG;지표/NNG;양호/NNG,16,9,25,1.6113436767967546,Hawkish
니리/NNG,16,7,23,2.0717275844529706,Hawkish
국무총리/NNG,33,7,40,4.272938142934252,Hawkish
자증/NNG,102,51,153,1.8127616363963488,Hawkish
주택수/NNG,137,10,147,12.417417209314989,Hawkish
친구/NNG,72,16,88,4.078713681891785,Hawkish
현금배당/NNG,28,15,43,1.6919108606365922,Hawkish
스위트/NNG,18,6,24,2.7191424545945235,Hawkish
자금/NNG;조달/NNG;여건/NNG;악화/NNG,17,9,26,1.7120526565965517,Hawkish
숏커버링/NNG,33,23,56,1.3004594348060765,Hawkish
수상/NNG,44,27,71,1.4770650370636915,Hawkish
가격/NNG;높/VV,13,9,22,1.309216737397363,Hawkish
소비자/NNG;물가/NNG;금리/NNG;인하/NNG,11,6,17,1.661698166696653,Hawkish
숙박/NNG,158,81,239,1.7680020898186612,Hawkish
광모/NNG,13,8,21,1.4728688295720334,Hawkish
뜨뜻미지근/NNG,40,2,42,18.12761636396349,Hawkish
넉넉/NNG,58,40,98,1.314252186387353,Hawkish
품귀/NNG,12,8,20,1.3595712272972615,Hawkish
낯선/VA,26,10,36,2.3565901273152536,Hawkish
물가/NNG;금리/NNG;인하/NNG,26,8,34,2.9457376591440667,Hawkish
불확실성/NNG;증가/NNG,34,20,54,1.5408473909368965,Hawkish
글로벌/NNG;경기/NNG;부진/NNG,17,8,25,1.9260592386711206,Hawkish
블랙/NNG,27,18,45,1.3595712272972618,Hawkish
종교/NNG,23,16,39,1.3029224261598757,Hawkish
매트릭스/NNG,28,18,46,1.4099257171971604,Hawkish
내내년/NNG,48,27,75,1.6113436767967546,Hawkish
메리/NNG,12,7,19,1.5537956883397277,Hawkish
인선/NNG,29,17,46,1.5461790428086506,Hawkish
영업자산/NNG,152,61,213,2.2585226945265986,Hawkish
회색/NNG,73,21,94,3.1507523680222254,Hawkish
대학원/NNG,59,22,81,2.4307485578951042,Hawkish
경상/NNG;흑자/NNG,14,6,20,2.1148885757957405,Hawkish
여력/NNG;제한/NNG,41,21,62,1.7696006450535784,Hawkish
반문/NNG,14,9,23,1.4099257171971604,Hawkish
국상/NNG,14,9,23,1.4099257171971604,Hawkish
환매조건부채권매각/NNG,11,6,17,1.661698166696653,Hawkish
바짝/MAG,45,31,76,1.3157140909328338,Hawkish
착시/NNG,33,19,52,1.574240368449461,Hawkish
요즘/MAG,13,6,19,1.9638251060960445,Hawkish
지와/NNG,20,13,33,1.3944320279971913,Hawkish
비밀/NNG,23,12,35,1.737229901546501,Hawkish
경제/NNG;전망/NNG;성장/NNG,14,9,23,1.4099257171971604,Hawkish
전망/NNG;상승/NNG,86,51,137,1.528406869902804,Hawkish
fed/NNG;ff/NNG;목표/NNG;금리/NNG;인상/NNG,21,10,31,1.9033997182161664,Hawkish
자연실업률/NNG,86,50,136,1.5589750073008601,Hawkish
예상/NNG;상승/NNG,61,25,86,2.2115691964035458,Hawkish
윤현/NNG,41,19,60,1.9558743971644816,Hawkish
기화/NNG,24,14,38,1.5537956883397277,Hawkish
수출/NNG;확대/NNG,25,16,41,1.4162200284346476,Hawkish
신용스프레드/NNG;고점/NNG,14,5,19,2.5378662909548884,Hawkish
우려/NNG;위험/NNG;회피/NNG,16,3,19,4.834031030390264,Hawkish
우려/NNG;증대/NNG,15,10,25,1.3595712272972615,Hawkish
축수/NNG,21,2,23,9.516998591080831,Hawkish
수익성/NNG;방어/NNG,11,7,18,1.424312714311417,Hawkish
택했/VV,16,10,26,1.4502093091170791,Hawkish
퇴직연금/NNG,92,48,140,1.737229901546501,Hawkish
착한/VA,21,9,30,2.1148885757957405,Hawkish
물가/NNG;상승/NNG;압력/NNG;크/VV,13,6,19,1.9638251060960445,Hawkish
육교/NNG,20,7,27,2.589659480566213,Hawkish
절절절절/MAG,54,28,82,1.7480201493821939,Hawkish
순환적/VAX,85,40,125,1.9260592386711206,Hawkish
배당수익률/NNG,186,76,262,2.2182477919060584,Hawkish
큼큼/MAG,29,10,39,2.628504372774706,Hawkish
파일럿/NNG,13,8,21,1.4728688295720334,Hawkish
안보리/NNG,29,9,38,2.920560414194118,Hawkish
진지/NNG,34,19,53,1.6219446220388385,Hawkish
경쟁사/NNG,72,41,113,1.5916931441528919,Hawkish
부채한도/NNG;협상/NNG;불확실성/NNG,12,8,20,1.3595712272972615,Hawkish
경제/NNG;성장률/NNG;낮/VA,36,17,53,1.9193946738314283,Hawkish
필라델피아제조업지수/NNG,18,10,28,1.631485472756714,Hawkish
공급/NNG;차질/NNG,61,19,80,2.909959468952034,Hawkish
선물환/NNG,203,105,308,1.7523362485164704,Hawkish
벤처/NNG,68,23,91,2.679734592933733,Hawkish
원화/NNG;절하/NNG,41,18,59,2.0645340858958416,Hawkish
내부요인/NNG,16,11,27,1.3183720991973447,Hawkish
서로/NNG,14,9,23,1.4099257171971604,Hawkish
천장/NNG,16,4,20,3.6255232727926976,Hawkish
수요/NNG;억제/NNG,24,16,40,1.3595712272972615,Hawkish
소급/NNG,12,8,20,1.3595712272972615,Hawkish
국제/NNG;유가상승/NNG,12,7,19,1.5537956883397277,Hawkish
외치/VV,16,10,26,1.4502093091170791,Hawkish
분분/NNG,710,483,1193,1.3323610371029064,Hawkish
중개인/NNG,17,8,25,1.9260592386711206,Hawkish
인준/NNG,29,6,35,4.380840621291177,Hawkish
이념/NNG,25,14,39,1.618537175353883,Hawkish
에르/NNG,26,12,38,1.9638251060960445,Hawkish
개구리/NNG,25,11,36,2.059956404995851,Hawkish
바작/NNG,18,11,29,1.4831686115970129,Hawkish
액면가/NNG,42,28,70,1.3595712272972618,Hawkish
난항/NNG,104,71,175,1.3276564097550725,Hawkish
금리/NNG;제약/NNG,68,31,99,1.9881901818540597,Hawkish
흡흡/MAG,13,8,21,1.4728688295720334,Hawkish
내수/NNG,1855,1163,3018,1.4456890952344053,Hawkish
침체/NNG;위험/NNG,17,9,26,1.7120526565965517,Hawkish
비대칭/NNG,38,24,62,1.4351029621471094,Hawkish
일부구간/NNG,23,7,30,2.978108402651145,Hawkish
불분명/NNG,40,26,66,1.3944320279971913,Hawkish
각하/NNG,17,10,27,1.5408473909368965,Hawkish
진폭/NNG,23,15,38,1.389783921237201,Hawkish
인플레이션/NNG;우려/NNG;완화/NNG,18,10,28,1.631485472756714,Hawkish
때로/MAG,27,15,42,1.631485472756714,Hawkish
매수의견/NNG,34,20,54,1.5408473909368965,Hawkish
의사봉/NNG,45,3,48,13.595712272972616,Hawkish
비국/NNG,13,8,21,1.4728688295720334,Hawkish
토목/NNG,31,17,48,1.6528120802437296,Hawkish
전문투자자/NNG,37,11,48,3.0487354793938595,Hawkish
경기/NNG;침체/NNG;피하/VV,24,16,40,1.3595712272972615,Hawkish
사증/NNG,12,6,18,1.8127616363963488,Hawkish
커플링/NNG,23,9,32,2.3163065353953347,Hawkish
물가/NNG;높/VA,99,59,158,1.5208762881630384,Hawkish
분기기/NNG,62,31,93,1.8127616363963486,Hawkish
전입액/NNG,50,13,63,3.4860800699929784,Hawkish
강점/NNG,72,49,121,1.3318248757197666,Hawkish
정상화계획/NNG,24,13,37,1.6733184335966296,Hawkish
반기/VV,67,39,106,1.5571157645968636,Hawkish
고정금리채/NNG,11,6,17,1.661698166696653,Hawkish
돌파구/NNG,25,13,38,1.7430400349964892,Hawkish
식업/NNG,13,6,19,1.9638251060960445,Hawkish
반토막/NNG,30,20,50,1.3595712272972615,Hawkish
rqfii/NNG,19,9,28,1.9134706161961461,Hawkish
사모/NNG,1301,827,2128,1.4258784092815293,Hawkish
인플레이션/NNG;낮/VA,58,40,98,1.314252186387353,Hawkish
스타트업/NNG,136,57,193,2.1625928293851175,Hawkish
방증/NNG,109,59,168,1.6745001556542545,Hawkish
민평/NNG;금리/NNG;낮/VA,13,9,22,1.309216737397363,Hawkish
노호/NNG,132,46,178,2.600918869612153,Hawkish
출격/NNG,13,8,21,1.4728688295720334,Hawkish
불용/NNG,24,3,27,7.251046545585395,Hawkish
평상시/NNG,19,12,31,1.4351029621471094,Hawkish
오름/NNG,1543,859,2402,1.6281089667983508,Hawkish
미용/NNG,29,3,32,8.761681242582354,Hawkish
메이/NNG,12,7,19,1.5537956883397277,Hawkish
스태프/NNG,32,22,54,1.3183720991973447,Hawkish
인하/NNG;기대/NNG;축소/NNG,13,9,22,1.309216737397363,Hawkish
소비/NNG;약화/NNG,16,6,22,2.417015515195132,Hawkish
초청/NNG,39,21,60,1.6832786623680382,Hawkish
답변자/NNG,31,10,41,2.8097805364143404,Hawkish
세전/NNG,33,19,52,1.574240368449461,Hawkish
국제/NNG;유가/NNG;상승/NNG,112,73,185,1.390611666276651,Hawkish
전망/NNG;개선/NNG,32,22,54,1.3183720991973447,Hawkish
트랙터/NNG,19,3,22,5.740411848588438,Hawkish
아웃/NNG,261,101,362,2.342231619304193,Hawkish
벌벌벌벌/MAG,71,30,101,2.1451012697356795,Hawkish
인플레이션/NNG;기대/NNG;높/VA,23,11,34,1.895159892596183,Hawkish
변질/NNG,12,7,19,1.5537956883397277,Hawkish
기저효과/NNG;수요/NNG;압력/NNG,17,10,27,1.5408473909368965,Hawkish
간부/NNG,33,13,46,2.300812846195366,Hawkish
발계/NNG,17,2,19,7.704236954684482,Hawkish
신산업/NNG,30,10,40,2.719142454594523,Hawkish
공고히/MAG,28,17,45,1.4928625240911106,Hawkish
식음료/NNG,42,22,64,1.7303633801965148,Hawkish
공립/NNG,13,5,18,2.3565901273152536,Hawkish
구두/NNG,370,177,547,1.8946943657249973,Hawkish
흡수력/NNG,40,22,62,1.647965123996681,Hawkish
예상/NNG;확대/NNG,34,12,46,2.5680789848948273,Hawkish
채울/VV,21,9,30,2.1148885757957405,Hawkish
일회성비용/NNG,26,14,40,1.6832786623680382,Hawkish
뇌관/NNG,22,10,32,1.9940378000359835,Hawkish
높/VA;이자/NNG;부담/NNG,13,7,20,1.6832786623680382,Hawkish
인민/NNG,35,19,54,1.6696488756282162,Hawkish
집중도/NNG,31,12,43,2.3414837803452837,Hawkish
신성장동력/NNG,48,21,69,2.07172758445297,Hawkish
이루어짐/VV,27,16,43,1.5295176307094194,Hawkish
공급/NNG;개선/NNG,17,5,22,3.081694781873793,Hawkish
여력/NNG;크/VV,20,11,31,1.647965123996681,Hawkish
누빈/VV,15,5,20,2.719142454594523,Hawkish
확장국면/NNG,210,138,348,1.3792751581276568,Hawkish
요원/NNG,76,41,117,1.6801205410502746,Hawkish
글로컬/NNG,14,8,22,1.5861664318468052,Hawkish
다이버/NNG,49,7,56,6.344665727387222,Hawkish
동그라미/NNG,55,34,89,1.4662042647323408,Hawkish
기행/NNG,12,6,18,1.8127616363963488,Hawkish
통일/NNG,50,25,75,1.8127616363963488,Hawkish
삼가/VV,24,14,38,1.5537956883397277,Hawkish
계양/NNG,21,12,33,1.5861664318468052,Hawkish
제이차/NNG,157,68,225,2.092673359663432,Hawkish
설명력/NNG,47,19,66,2.2420999187007475,Hawkish
고졸/NNG,19,8,27,2.1526544432206642,Hawkish
추진력/NNG,49,27,76,1.6449133367300204,Hawkish
파급시차/NNG,25,4,29,5.66488011373859,Hawkish
기부금/NNG,17,6,23,2.5680789848948273,Hawkish
기념식/NNG,23,13,36,1.6035968321967702,Hawkish
냉정/NNG,27,14,41,1.7480201493821939,Hawkish
통화정책/NNG;인상/NNG,15,8,23,1.699464034121577,Hawkish
둔화/NNG;압력/NNG,23,11,34,1.895159892596183,Hawkish
수진/NNG,47,1,48,42.599898455314204,Hawkish
방공/NNG,32,4,36,7.251046545585395,Hawkish
총합계/NNG,30,20,50,1.3595712272972615,Hawkish
물가/NNG;상승률/NNG;둔화/NNG,155,93,248,1.5106346969969575,Hawkish
도제/NNG,18,4,22,4.078713681891785,Hawkish
경제활동참가율/NNG;상승/NNG,12,8,20,1.3595712272972615,Hawkish
퉁퉁/MAG,14,3,17,4.229777151591481,Hawkish
안녕/NNG,46,14,60,2.978108402651145,Hawkish
거리/NNG,281,169,450,1.507059230258503,Hawkish
투자등급채/NNG,76,45,121,1.5307764929569168,Hawkish
북빌딩/NNG,60,40,100,1.3595712272972615,Hawkish
gdp/NNG;예상/NNG;상회/NNG,15,9,24,1.5106346969969573,Hawkish
예대비율/NNG,16,8,24,1.8127616363963488,Hawkish
세전이익/NNG,97,34,131,2.585851157800674,Hawkish
플레이어/NNG,22,15,37,1.3293585333573226,Hawkish
배출권/NNG,62,5,67,11.239122145657362,Hawkish
정치/NNG;부담/NNG,16,11,27,1.3183720991973447,Hawkish
절약/NNG,31,18,49,1.560989186896856,Hawkish
측근/NNG,17,10,27,1.5408473909368965,Hawkish
소득/NNG;감소/NNG,25,8,33,2.832440056869295,Hawkish
더디/VA,599,396,995,1.3710154295472388,Hawkish
가격/NNG;오름/NNG;둔화/NNG,48,21,69,2.07172758445297,Hawkish
eps/NNG,494,247,741,1.812761636396349,Hawkish
따라잡/VV,36,23,59,1.418683019788447,Hawkish
정말/MAG,124,65,189,1.7290957147165174,Hawkish
의향/NNG,20,11,31,1.647965123996681,Hawkish
국방비/NNG,65,32,97,1.8410860369650417,Hawkish
금리/NNG;부정적/VAX,13,7,20,1.6832786623680382,Hawkish
소재지/NNG,16,2,18,7.251046545585395,Hawkish
보폭/NNG,21,5,26,3.8067994364323328,Hawkish
상상/NNG,3232,1452,4684,2.017508818468664,Hawkish
유가/NNG;우려/NNG,14,4,18,3.1723328636936103,Hawkish
전략비축유/NNG,39,10,49,3.5348851909728802,Hawkish
모를/VV,46,22,68,1.895159892596183,Hawkish
발의/NNG,54,32,86,1.5295176307094194,Hawkish
은행간시장/NNG,14,3,17,4.229777151591481,Hawkish
석유파동/NNG,18,4,22,4.078713681891785,Hawkish
수요/NNG;약화/NNG,55,33,88,1.5106346969969575,Hawkish
탁월/NNG,16,8,24,1.8127616363963488,Hawkish
상향/NNG;안정/NNG,31,20,51,1.4048902682071702,Hawkish
상위기업/NNG,20,11,31,1.647965123996681,Hawkish
위험/NNG;상방/NNG,13,4,17,2.9457376591440667,Hawkish
공기/NNG,21,12,33,1.5861664318468052,Hawkish
들들들/MAG,40,13,53,2.7888640559943827,Hawkish
각도/NNG,36,18,54,1.812761636396349,Hawkish
럭셔리/NNG,18,12,30,1.3595712272972618,Hawkish
긴축/NNG;금리/NNG;인상/NNG,12,8,20,1.3595712272972615,Hawkish
배후/NNG,81,22,103,3.3371293760932788,Hawkish
저탄소/NNG,87,37,124,2.131219761709221,Hawkish
일감/NNG,30,8,38,3.398928068243154,Hawkish
인리/NNG,14,6,20,2.1148885757957405,Hawkish
이어진다는/VV,20,11,31,1.647965123996681,Hawkish
국토교통부/NNG,166,85,251,1.7701084214223173,Hawkish
경제/NNG;활동/NNG;제약/NNG,24,14,38,1.5537956883397277,Hawkish
외화부채/NNG,32,9,41,3.222687353593509,Hawkish
무인기/NNG,36,8,44,4.078713681891785,Hawkish
예상/NNG;금리/NNG;인상/NNG,46,27,73,1.544204356930223,Hawkish
퇴직금/NNG,12,8,20,1.3595712272972615,Hawkish
상당폭/NNG,399,239,638,1.5131629559040651,Hawkish
환영/NNG,82,35,117,2.1235207740642945,Hawkish
문턱/NNG,48,29,77,1.5002165266728402,Hawkish
말잔/NNG,40,26,66,1.3944320279971913,Hawkish
청소년/NNG,23,13,36,1.6035968321967702,Hawkish
하방/NNG;지지/NNG,18,5,23,3.262970945513428,Hawkish
거스를/VV,26,7,33,3.3665573247360765,Hawkish
물러섰/VV,20,7,27,2.589659480566213,Hawkish
국책은행/NNG,85,42,127,1.8343421320677338,Hawkish
금리/NNG;커브/NNG;플래트닝/NNG,12,8,20,1.3595712272972615,Hawkish
대내외/NNG;여건/NNG;불확실성/NNG,15,8,23,1.699464034121577,Hawkish
이익/NNG;성장/NNG,13,9,22,1.309216737397363,Hawkish
물가/NNG;악순환/NNG,11,6,17,1.661698166696653,Hawkish
자본/NNG;통제/NNG,12,8,20,1.3595712272972615,Hawkish
민첩/NNG,14,6,20,2.1148885757957405,Hawkish
상장잔액/NNG,29,2,31,13.14252186387353,Hawkish
용액/NNG,16,8,24,1.8127616363963488,Hawkish
증권저축/NNG,12,5,17,2.1753139636756185,Hawkish
아직/MAG;금리/NNG;인상/NNG,22,15,37,1.3293585333573226,Hawkish
신재/NNG,29,18,47,1.460280207097059,Hawkish
소비/NNG;심리/NNG;악화/NNG,16,7,23,2.0717275844529706,Hawkish
인하/NNG;불확실성/NNG,17,9,26,1.7120526565965517,Hawkish
눈치/NNG,75,46,121,1.4777948122796323,Hawkish
물간/NNG,19,4,23,4.3053088864413285,Hawkish
지수/NNG;반등/NNG,13,5,18,2.3565901273152536,Hawkish
저축대부조합/NNG,29,3,32,8.761681242582354,Hawkish
확장/NNG;하회/NNG,13,5,18,2.3565901273152536,Hawkish
인상/NNG;끝/NNG,13,7,20,1.6832786623680382,Hawkish
내수/NNG;부양/NNG,25,12,37,1.8882933712461967,Hawkish
금리/NNG;인하/NNG;자신/NNG,27,17,44,1.4395460053735711,Hawkish
지하/NNG,34,21,55,1.467473705654187,Hawkish
뉘앙스/NNG,50,29,79,1.5627255486175422,Hawkish
소비/NNG;둔화/NNG,113,57,170,1.7968602185332228,Hawkish
고용/NNG;지표/NNG;견조/NNG,27,18,45,1.3595712272972618,Hawkish
반증/NNG,52,31,83,1.5203807273001635,Hawkish
압축/NNG,47,18,65,2.3666610252952336,Hawkish
듀레이션/NNG;길/VA,31,17,48,1.6528120802437296,Hawkish
주택/NNG;지표/NNG;부진/NNG,13,5,18,2.3565901273152536,Hawkish
fcf/NNG,133,72,205,1.674286789171628,Hawkish
고창/NNG,16,5,21,2.9004186182341583,Hawkish
평형/NNG,23,2,25,10.423379409279006,Hawkish
침체국면/NNG,204,100,304,1.8490168691242757,Hawkish
달치/NNG,16,7,23,2.0717275844529706,Hawkish
물가/NNG;잡/VV,52,35,87,1.3466229298944306,Hawkish
레버리지/NNG;높/VA,13,9,22,1.309216737397363,Hawkish
배출량/NNG,225,59,284,3.45653701855236,Hawkish
경상/NNG;수지/NNG;개선/NNG,24,14,38,1.5537956883397277,Hawkish
금리/NNG;고점/NNG,89,45,134,1.7926198404363893,Hawkish
트리플강세/NNG,17,8,25,1.9260592386711206,Hawkish
함정/NNG,38,26,64,1.3247104265973317,Hawkish
고용자수/NNG;회복/NNG,18,4,22,4.078713681891785,Hawkish
개선/NNG;상향/NNG,15,3,18,4.531904090990872,Hawkish
경기/NNG;하방/NNG;위험/NNG;크/VV,26,6,32,3.927650212192089,Hawkish
자당/NNG,17,6,23,2.5680789848948273,Hawkish
농담/NNG,19,4,23,4.3053088864413285,Hawkish
적획/NNG,56,37,93,1.3718196167323722,Hawkish
식료품/NNG,446,288,734,1.403631405959673,Hawkish
태풍/NNG,35,23,58,1.3792751581276568,Hawkish
발동/NNG,91,44,135,1.8745603285462247,Hawkish
매출/NNG;감소/NNG,75,42,117,1.6185371753538829,Hawkish
금과은/NNG,16,3,19,4.834031030390264,Hawkish
재택근무/NNG,32,21,53,1.3811517229686467,Hawkish
상호기금/NNG,12,7,19,1.5537956883397277,Hawkish
다다르/VV,15,3,18,4.531904090990872,Hawkish
opec/NNG;감산/NNG,51,32,83,1.4445444290033405,Hawkish
미결정/NNG,38,2,40,17.221235545765314,Hawkish
다행히/MAG,90,56,146,1.4566834578184946,Hawkish
신용공여액/NNG,13,8,21,1.4728688295720334,Hawkish
신계약/NNG,54,35,89,1.398416119505755,Hawkish
계절조정/NNG,453,270,723,1.520705594976937,Hawkish
둔화/NNG,11352,7671,19023,1.3413160015885381,Hawkish
위험자산/NNG;선호/NNG;위축/NNG,16,3,19,4.834031030390264,Hawkish
물가/NNG;금리/NNG;상승/NNG,16,8,24,1.8127616363963488,Hawkish
거래액/NNG,41,17,58,2.1859772674191262,Hawkish
오디세이아/NNG,22,6,28,3.323396333393306,Hawkish
정액/NNG,34,16,50,1.9260592386711206,Hawkish
잠재/NNG;성장률/NNG;하회/NNG,26,9,35,2.618433474794726,Hawkish
서브프라임사태/NNG,39,21,60,1.6832786623680382,Hawkish
오판/NNG,18,11,29,1.4831686115970129,Hawkish
재보험/NNG,22,8,30,2.4925472500449795,Hawkish
계약자/NNG,16,11,27,1.3183720991973447,Hawkish
사노피/NNG,15,8,23,1.699464034121577,Hawkish
포트/NNG,66,42,108,1.424312714311417,Hawkish
반려/NNG,20,5,25,3.625523272792698,Hawkish
위탁/NNG,86,49,135,1.590790823776388,Hawkish
하락/NNG;회복/NNG,13,7,20,1.6832786623680382,Hawkish
계층/NNG,114,53,167,1.9495738353696583,Hawkish
자산/NNG;늘/VV,25,11,36,2.059956404995851,Hawkish
따른다/VV,18,10,28,1.631485472756714,Hawkish
예산/NNG,591,408,999,1.3129192734194146,Hawkish
결손/NNG,90,25,115,3.2629709455134277,Hawkish
거시경제금융회의/NNG,31,19,50,1.4788318612707056,Hawkish
물가/NNG;상승률/NNG;넘/VV,11,6,17,1.661698166696653,Hawkish
외무/NNG,35,6,41,5.28722143948935,Hawkish
근로자의날/NNG,22,5,27,3.988075600071967,Hawkish
fed/NNG;금리/NNG;인상/NNG;가능성/NNG;높/VA,11,7,18,1.424312714311417,Hawkish
소음/NNG,31,10,41,2.8097805364143404,Hawkish
임재/NNG,16,7,23,2.0717275844529706,Hawkish
부정적/VAX;안정/NNG;부정적/VAX,18,12,30,1.3595712272972618,Hawkish
주자/NNG,54,37,91,1.3228260589919303,Hawkish
전망/NNG;웃돌/VV,71,34,105,1.8927364144726582,Hawkish
원지수/NNG,21,4,25,4.758499295540416,Hawkish
재시공/NNG,11,7,18,1.424312714311417,Hawkish
샐러드/NNG,19,10,29,1.7221235545765314,Hawkish
구멍/NNG,22,10,32,1.9940378000359835,Hawkish
예산편성/NNG,16,9,25,1.6113436767967546,Hawkish
경제/NNG;성장률/NNG;둔화/NNG,37,24,61,1.3973370947221855,Hawkish
성원/NNG,11,6,17,1.661698166696653,Hawkish
배배/MAG,69,37,106,1.6902777420452442,Hawkish
끔찍/NNG,16,8,24,1.8127616363963488,Hawkish
증권자금/NNG,70,22,92,2.8839389669941915,Hawkish
드러냄/VV,11,7,18,1.424312714311417,Hawkish
서서/NNG,401,199,600,1.826425668831497,Hawkish
어르신/NNG,12,5,17,2.1753139636756185,Hawkish
하이브리드/NNG,49,32,81,1.3878956278659547,Hawkish
난감/NNG,16,4,20,3.6255232727926976,Hawkish
스민/VV,17,8,25,1.9260592386711206,Hawkish
국제/NNG;원자재/NNG;가격/NNG;상승/NNG,20,9,29,2.0141795959959437,Hawkish
트릴/NNG,14,9,23,1.4099257171971604,Hawkish
가격/NNG;강세/NNG,31,18,49,1.560989186896856,Hawkish
세입자/NNG,44,11,55,3.6255232727926976,Hawkish
유동부채/NNG,77,20,97,3.4895661500629718,Hawkish
esg투자/NNG,199,47,246,3.8376549536475895,Hawkish
장률/NNG,87,46,133,1.7142419822443733,Hawkish
성금요일/NNG,74,12,86,5.589348378888742,Hawkish
성장/NNG;경로/NNG;불확실성/NNG;높/VA,29,13,42,2.0219264405959274,Hawkish
용납/NNG,14,8,22,1.5861664318468052,Hawkish
잔치/NNG,47,16,63,2.6624936534571377,Hawkish
뜯어보/VV,314,156,470,1.8243819032963253,Hawkish
예상/NNG;지연/NNG,23,11,34,1.895159892596183,Hawkish
수요/NNG;제약/NNG,13,6,19,1.9638251060960445,Hawkish
량도/NNG,22,15,37,1.3293585333573226,Hawkish
카드/NNG,837,513,1350,1.4788318612707056,Hawkish
순이익/NNG;감소/NNG,37,14,51,2.3954350195237466,Hawkish
압승/NNG,55,18,73,2.769496944494422,Hawkish
재발/NNG,96,56,152,1.5537956883397277,Hawkish
일문일답/NNG,32,10,42,2.9004186182341583,Hawkish
호실적/NNG,136,75,211,1.6435705503326896,Hawkish
정연/NNG,22,2,24,9.970189000179918,Hawkish
협동/NNG,13,5,18,2.3565901273152536,Hawkish
수수수/MAG,595,388,983,1.3899396567729738,Hawkish
경기/NNG;모멘텀/NNG;둔화/NNG,33,22,55,1.3595712272972618,Hawkish
유동성/NNG;위험/NNG,64,42,106,1.3811517229686467,Hawkish
구역/NNG,142,36,178,3.575168782892799,Hawkish
줄기/NNG,14,8,22,1.5861664318468052,Hawkish
인다/VV,14,3,17,4.229777151591481,Hawkish
리도/NNG,16,7,23,2.0717275844529706,Hawkish
소비/NNG;회복/NNG;더디/VA,15,4,19,3.398928068243154,Hawkish
벤처펀드/NNG,12,7,19,1.5537956883397277,Hawkish
연방예금보험공사/NNG,24,14,38,1.5537956883397277,Hawkish
환입/NNG,48,22,70,1.977558148796017,Hawkish
누그러졌/VV,49,26,75,1.7081792342965594,Hawkish
우선순위/NNG,144,76,220,1.7173531292175939,Hawkish
급랭/NNG,24,12,36,1.8127616363963488,Hawkish
쌓여/VV,48,25,73,1.7402511709404949,Hawkish
대미/NNG;무역/NNG;흑자/NNG,11,6,17,1.661698166696653,Hawkish
등록제/NNG,16,5,21,2.9004186182341583,Hawkish
발사/NNG,105,64,169,1.48703102985638,Hawkish
악천후/NNG,17,3,20,5.136157969789655,Hawkish
진격/NNG,14,4,18,3.1723328636936103,Hawkish
부동산/NNG;상승/NNG,20,5,25,3.625523272792698,Hawkish
대유/NNG,30,17,47,1.5994955615261899,Hawkish
비용/NNG;부담/NNG,79,51,130,1.404001659561878,Hawkish
어색/NNG,19,11,30,1.5655668677968468,Hawkish
관찰대상국/NNG,49,20,69,2.2206330045855274,Hawkish
소매/NNG;판매/NNG;둔화/NNG,14,5,19,2.5378662909548884,Hawkish
인구증가/NNG,22,13,35,1.5338752307969103,Hawkish
크라우드펀딩/NNG,29,5,34,5.257008745549412,Hawkish
수요/NNG;살/VV,12,6,18,1.8127616363963488,Hawkish
테이퍼링/NNG,525,335,860,1.4204475509075867,Hawkish
베이비부머/NNG,28,12,40,2.1148885757957405,Hawkish
건전성/NNG;악화/NNG,20,13,33,1.3944320279971913,Hawkish
내수/NNG;개선/NNG,25,8,33,2.832440056869295,Hawkish
채였/VV,12,6,18,1.8127616363963488,Hawkish
복사/NNG,436,288,724,1.3721598497722365,Hawkish
물가/NNG;상방/NNG;위험/NNG,65,24,89,2.4547813826200557,Hawkish
플레이스/NNG,19,6,25,2.870205924294219,Hawkish
형편/NNG,13,9,22,1.309216737397363,Hawkish
줄어든다면/VV,15,9,24,1.5106346969969573,Hawkish
결기/NNG,25,4,29,5.66488011373859,Hawkish
휴일/NNG,68,44,112,1.4007703553971786,Hawkish
러셀지수/NNG,12,6,18,1.8127616363963488,Hawkish
채금/NNG,13,6,19,1.9638251060960445,Hawkish
때때때때/MAG,57,19,76,2.7191424545945235,Hawkish
완화/NNG;상승/NNG,14,6,20,2.1148885757957405,Hawkish
예상/NNG;견조/NNG,59,38,97,1.4072754808866392,Hawkish
피크/NNG,436,98,534,4.03246976259596,Hawkish
가격/NNG;지지/NNG,17,10,27,1.5408473909368965,Hawkish
무역협회/NNG,27,7,34,3.4960402987643877,Hawkish
경제/NNG;지표/NNG;양호/NNG,25,17,42,1.332912967938492,Hawkish
미/NNG;국채/NNG;금리/NNG;급락/NNG,16,2,18,7.251046545585395,Hawkish
긴박감/NNG,15,10,25,1.3595712272972615,Hawkish
유가/NNG;지지/NNG,23,7,30,2.978108402651145,Hawkish
임금격차/NNG,13,9,22,1.309216737397363,Hawkish
아웃풋갭/NNG,78,23,101,3.073813209541635,Hawkish
소비자/NNG;물가/NNG;오르/VV,25,17,42,1.332912967938492,Hawkish
책임준비금/NNG,74,18,92,3.726232252592495,Hawkish
캐리/NNG;부담/NNG,13,7,20,1.6832786623680382,Hawkish
고점/NNG,1666,1065,2731,1.4178689606743273,Hawkish
금융시장/NNG;상승/NNG,12,7,19,1.5537956883397277,Hawkish
속등/NNG,20,11,31,1.647965123996681,Hawkish
위험/NNG;증대/NNG,41,22,63,1.689164252096598,Hawkish
교훈/NNG,50,19,69,2.3852126794688804,Hawkish
산술/NNG,14,6,20,2.1148885757957405,Hawkish
신용/NNG;위축/NNG,16,5,21,2.9004186182341583,Hawkish
국민소득/NNG,34,20,54,1.5408473909368965,Hawkish
매도가능증권/NNG,29,7,36,3.755006246821009,Hawkish
널리/MAG,26,12,38,1.9638251060960445,Hawkish
초당/NNG,13,7,20,1.6832786623680382,Hawkish
방정식/NNG,19,5,24,3.444247109153063,Hawkish
기고효과/NNG,55,3,58,16.61698166696653,Hawkish
시차/NNG,764,527,1291,1.313994203232268,Hawkish
ecb/NNG;매파/NNG,29,15,44,1.7523362485164709,Hawkish
매출인식/NNG,11,6,17,1.661698166696653,Hawkish
안통/NNG,308,143,451,1.9522048391960682,Hawkish
비경쟁인수/NNG,59,35,94,1.5278990935340655,Hawkish
종착점/NNG,27,11,38,2.224752917395519,Hawkish
시간외거래/NNG,160,87,247,1.6669072518587118,Hawkish
스태그플레이션/NNG;우려/NNG,49,15,64,2.9608440061140366,Hawkish
중간선거/NNG,130,78,208,1.5106346969969573,Hawkish
자산/NNG;확대/NNG,28,14,42,1.812761636396349,Hawkish
금안/NNG,182,103,285,1.6015661059424056,Hawkish
높이/NNG,96,44,140,1.977558148796017,Hawkish
적지/NNG,14,4,18,3.1723328636936103,Hawkish
금리/NNG;원달러/NNG;상승/NNG,15,4,19,3.398928068243154,Hawkish
처장/NNG,27,10,37,2.447228209135071,Hawkish
중중/NNG,599,342,941,1.5874915500020657,Hawkish
인플레이션/NNG;상방/NNG;위험/NNG,38,20,58,1.7221235545765314,Hawkish
대국민/NNG,29,9,38,2.920560414194118,Hawkish
제사/NNG,11,7,18,1.424312714311417,Hawkish
서열/NNG,15,10,25,1.3595712272972615,Hawkish
위험/NNG;확산/NNG,27,16,43,1.5295176307094194,Hawkish
수비/NNG,11,6,17,1.661698166696653,Hawkish
앞당겨졌/VV,20,9,29,2.0141795959959437,Hawkish
각인/NNG,14,5,19,2.5378662909548884,Hawkish
부가세/NNG,120,45,165,2.4170155151951316,Hawkish
수리/NNG,23,8,31,2.6058448523197515,Hawkish
채산성/NNG,38,18,56,1.9134706161961461,Hawkish
국토/NNG,54,31,85,1.5788569091194007,Hawkish
가해질/VV,25,14,39,1.618537175353883,Hawkish
만만/NNG,357,219,576,1.4775248954189417,Hawkish
마이너스값/NNG,16,8,24,1.8127616363963488,Hawkish
연한/VA,30,4,34,6.797856136486308,Hawkish
준채/NNG,12,7,19,1.5537956883397277,Hawkish
산업협회/NNG,14,7,21,1.812761636396349,Hawkish
매입채무/NNG,27,15,42,1.631485472756714,Hawkish
고용/NNG;지표/NNG;경계/NNG,13,7,20,1.6832786623680382,Hawkish
장용/NNG,15,5,20,2.719142454594523,Hawkish
바랐/VV,25,1,26,22.65952045495436,Hawkish
세미나/NNG,130,70,200,1.6832786623680382,Hawkish
진한/VA,28,16,44,1.5861664318468052,Hawkish
협동조합/NNG,14,5,19,2.5378662909548884,Hawkish
세수진도율/NNG,36,11,47,2.9663372231940257,Hawkish
유가/NNG;지정학/NNG;위험/NNG,13,6,19,1.9638251060960445,Hawkish
소비/NNG;심리/NNG;위축/NNG,37,19,56,1.765057382806971,Hawkish
지상/NNG,32,13,45,2.2310912447955062,Hawkish
축축/NNG,54,36,90,1.3595712272972618,Hawkish
기아/NNG,57,18,75,2.8702059242942193,Hawkish
수익성/NNG;약화/NNG,18,12,30,1.3595712272972618,Hawkish
상업화/NNG,13,5,18,2.3565901273152536,Hawkish
인상/NNG;경기/NNG;둔화/NNG,14,3,17,4.229777151591481,Hawkish
물가/NNG;충격/NNG,72,33,105,1.9775581487960172,Hawkish
평가서/NNG,19,10,29,1.7221235545765314,Hawkish
선두/NNG,68,43,111,1.433346410173857,Hawkish
만기보유증권/NNG,21,12,33,1.5861664318468052,Hawkish
단기자금시장/NNG;불안/NNG,22,14,36,1.424312714311417,Hawkish
꾸준/NNG,387,261,648,1.3439439718110862,Hawkish
기대/NNG;하회/NNG,18,12,30,1.3595712272972618,Hawkish
순기/NNG,30,14,44,1.9422446104246596,Hawkish
파티/NNG,20,11,31,1.647965123996681,Hawkish
가릴/VV,12,7,19,1.5537956883397277,Hawkish
학부/NNG,14,9,23,1.4099257171971604,Hawkish
수출/NNG;플러스/NNG,13,5,18,2.3565901273152536,Hawkish
수가/NNG,15,4,19,3.398928068243154,Hawkish
금융시장/NNG;위험/NNG;회피/NNG,13,7,20,1.6832786623680382,Hawkish
관문/NNG,15,6,21,2.265952045495436,Hawkish
레이트/NNG,43,23,66,1.6945380514139783,Hawkish
물가/NNG;지표/NNG;경계/NNG,20,12,32,1.5106346969969575,Hawkish
베이비스텝/NNG,32,14,46,2.0717275844529706,Hawkish
관세율/NNG,39,22,61,1.606765995896764,Hawkish
다세대/NNG,21,14,35,1.3595712272972618,Hawkish
추세선/NNG,51,21,72,2.2012105584812804,Hawkish
기국/NNG,50,23,73,1.9703930830395098,Hawkish
물가/NNG;상승률/NNG;상회/NNG,21,8,29,2.379249647770208,Hawkish
소신/NNG,14,8,22,1.5861664318468052,Hawkish
중요도/NNG,78,52,130,1.3595712272972615,Hawkish
민감/NNG;금리/NNG;하락/NNG,31,11,42,2.554345942194855,Hawkish
gdp/NNG;상승/NNG,16,11,27,1.3183720991973447,Hawkish
너리/NNG,20,8,28,2.2659520454954363,Hawkish
전기차/NNG,436,302,738,1.3085497905112717,Hawkish
형민/NNG,56,27,83,1.8799009562628803,Hawkish
대출/NNG;연체율/NNG;상승/NNG,14,7,21,1.812761636396349,Hawkish
전원/NNG,262,120,382,1.978931453066014,Hawkish
기준점/NNG,36,23,59,1.418683019788447,Hawkish
한참/NNG,44,24,68,1.661698166696653,Hawkish
물건/NNG,107,46,153,2.1083205988522753,Hawkish
신용등급/NNG;전망/NNG;하향/NNG,38,24,62,1.4351029621471094,Hawkish
재정/NNG;우려/NNG,19,9,28,1.9134706161961461,Hawkish
안전망/NNG,18,5,23,3.262970945513428,Hawkish
교교/NNG,74,47,121,1.427067671205636,Hawkish
확약/NNG,47,25,72,1.703995938212568,Hawkish
기술적/VAX;경기/NNG;침체/NNG,18,11,29,1.4831686115970129,Hawkish
위기관리/NNG,16,11,27,1.3183720991973447,Hawkish
생필품/NNG,29,12,41,2.1904203106455884,Hawkish
고분/NNG,16,2,18,7.251046545585395,Hawkish
절하/NNG;우려/NNG,20,2,22,9.063808181981745,Hawkish
취약국/NNG,41,14,55,2.654400967580368,Hawkish
운임/NNG,117,59,176,1.7973992496472273,Hawkish
주재/NNG,203,94,297,1.957396873342866,Hawkish
어렵/VA;금리/NNG;인상/NNG,18,9,27,1.812761636396349,Hawkish
화상/NNG,20,13,33,1.3944320279971913,Hawkish
팽팽/MAG,13,5,18,2.3565901273152536,Hawkish
금리/NNG;불확실성/NNG,55,29,84,1.7189981034792963,Hawkish
국채/NNG;발행/NNG;확대/NNG,33,22,55,1.3595712272972618,Hawkish
막막/NNG,108,13,121,7.529932951184834,Hawkish
우선시/NNG,44,25,69,1.5952302400287868,Hawkish
수주/NNG;확대/NNG,16,5,21,2.9004186182341583,Hawkish
기간프리미엄/NNG,329,222,551,1.343240041383781,Hawkish
리보금리/NNG,79,51,130,1.404001659561878,Hawkish
경제자유구역/NNG,24,3,27,7.251046545585395,Hawkish
이수/NNG,29,7,36,3.755006246821009,Hawkish
째째/NNG,15,6,21,2.265952045495436,Hawkish
수출/NNG;회복/NNG,66,45,111,1.3293585333573226,Hawkish
고개/NNG,150,96,246,1.4162200284346476,Hawkish
재무/NNG;부담/NNG,82,54,136,1.3763560572638944,Hawkish
중개/NNG,146,68,214,1.946052933190198,Hawkish
변화율/NNG,64,42,106,1.3811517229686467,Hawkish
마마/NNG,187,103,290,1.6455651747869768,Hawkish
강하/VA;상승/NNG,33,23,56,1.3004594348060765,Hawkish
자산/NNG;가격/NNG;상승/NNG,47,30,77,1.4199966151771402,Hawkish
월중/NNG,93,39,132,2.1613696433956466,Hawkish
징계/NNG,17,10,27,1.5408473909368965,Hawkish
요충지/NNG,22,2,24,9.970189000179918,Hawkish
추락/NNG,104,48,152,1.9638251060960445,Hawkish
높/VA;물가/NNG;안정/NNG,33,23,56,1.3004594348060765,Hawkish
개입/NNG,1679,1009,2688,1.50823924058943,Hawkish
경기/NNG;둔화/NNG;압력/NNG,16,5,21,2.9004186182341583,Hawkish
자금/NNG;유입/NNG;둔화/NNG,27,12,39,2.0393568409458926,Hawkish
오미크론/NNG,79,9,88,7.956009404183976,Hawkish
국은/NNG,99,50,149,1.7946340200323851,Hawkish
도가/NNG,15,7,22,1.9422446104246596,Hawkish
가치사슬/NNG,25,4,29,5.66488011373859,Hawkish
합격/NNG,19,4,23,4.3053088864413285,Hawkish
현지법인/NNG,25,11,36,2.059956404995851,Hawkish
한중일/NNG,16,11,27,1.3183720991973447,Hawkish
자산/NNG;건전성/NNG;저하/NNG,26,16,42,1.4728688295720334,Hawkish
간주/NNG,107,61,168,1.589881107331224,Hawkish
집합/NNG,17,10,27,1.5408473909368965,Hawkish
높/VA;물가/NNG;상승/NNG;압력/NNG,23,8,31,2.6058448523197515,Hawkish
선발/NNG,26,16,42,1.4728688295720334,Hawkish
쉽/VA;금리/NNG;인하/NNG,14,6,20,2.1148885757957405,Hawkish
채권시장/NNG;소폭/MAG;강세/NNG,20,9,29,2.0141795959959437,Hawkish
원형/NNG,19,9,28,1.9134706161961461,Hawkish
절대로/MAG,14,5,19,2.5378662909548884,Hawkish
짊어지/VV,59,3,62,17.825489424564097,Hawkish
설상가상/NNG,18,6,24,2.7191424545945235,Hawkish
재고/NNG;증가/NNG,22,14,36,1.424312714311417,Hawkish
높/VA;인플레이션/NNG;금리/NNG;인상/NNG,14,4,18,3.1723328636936103,Hawkish
하반/NNG,119,51,170,2.11488857579574,Hawkish
쿠폰금리/NNG,45,25,70,1.6314854727567139,Hawkish
올레/NNG,143,87,230,1.4897983563487236,Hawkish
위험/NNG;경고/NNG,19,10,29,1.7221235545765314,Hawkish
거들/VV,18,9,27,1.812761636396349,Hawkish
금리/NNG;인하/NNG;늦/VV,38,14,52,2.460176506537902,Hawkish
제1금융권/NNG,24,13,37,1.6733184335966296,Hawkish
힘겨루기/NNG,13,4,17,2.9457376591440667,Hawkish
징역/NNG,28,11,39,2.3071511735953534,Hawkish
제약회사/NNG,22,6,28,3.323396333393306,Hawkish
뚫리/VV,15,8,23,1.699464034121577,Hawkish
연체액/NNG,25,7,32,3.237074350707766,Hawkish
감행/NNG,57,28,85,1.8451323799034267,Hawkish
과열/NNG;완화/NNG,12,6,18,1.8127616363963488,Hawkish
캡틴/NNG,18,2,20,8.15742736378357,Hawkish
여소/NNG,36,14,50,2.3306935325095917,Hawkish
속하/VV,90,56,146,1.4566834578184946,Hawkish
해협/NNG,112,20,132,5.075732581909777,Hawkish
농업/NNG,129,74,203,1.58004223712925,Hawkish
원자재기업/NNG,17,5,22,3.081694781873793,Hawkish
콕스/NNG,13,7,20,1.6832786623680382,Hawkish
물가/NNG;상회/NNG,24,11,35,1.977558148796017,Hawkish
집집/NNG,33,22,55,1.3595712272972618,Hawkish
전자지갑/NNG,21,1,22,19.033997182161663,Hawkish
고갈/NNG,65,30,95,1.9638251060960445,Hawkish
금융시장/NNG;불안/NNG;확대/NNG,12,5,17,2.1753139636756185,Hawkish
국고채/NNG;금리/NNG;약세/NNG,12,7,19,1.5537956883397277,Hawkish
발효/NNG,53,33,86,1.4557025261970682,Hawkish
이동성/NNG,24,14,38,1.5537956883397277,Hawkish
신성장/NNG,31,21,52,1.3379907316258763,Hawkish
앨런/NNG,13,9,22,1.309216737397363,Hawkish
상승률/NNG;예상/NNG;웃돌/VV,13,9,22,1.309216737397363,Hawkish
기념사/NNG,12,7,19,1.5537956883397277,Hawkish
남음/NNG,13,8,21,1.4728688295720334,Hawkish
분조/NNG,12,8,20,1.3595712272972615,Hawkish
성장/NNG;전망/NNG;상향/NNG,18,9,27,1.812761636396349,Hawkish
보험금/NNG,69,47,116,1.3306441799079582,Hawkish
매수비중/NNG,23,13,36,1.6035968321967702,Hawkish
부채비율/NNG;개선/NNG,17,6,23,2.5680789848948273,Hawkish
플래트닝/NNG;압력/NNG,15,9,24,1.5106346969969573,Hawkish
억억/MAG,19,6,25,2.870205924294219,Hawkish
인상/NNG;확대/NNG,11,6,17,1.661698166696653,Hawkish
앞앞/NNG,73,24,97,2.7569083220194472,Hawkish
비용/NNG;압력/NNG,21,11,32,1.7303633801965148,Hawkish
실개입/NNG,179,80,259,2.0280270807184153,Hawkish
소요/NNG,515,341,856,1.3688742562230494,Hawkish
불완전/NNG,12,8,20,1.3595712272972615,Hawkish
일으키/VV,111,64,175,1.5720042315624587,Hawkish
물가/NNG;상승/NNG;압력/NNG;확대/NNG,16,8,24,1.8127616363963488,Hawkish
고국/NNG,301,149,450,1.831010914615104,Hawkish
유동자산/NNG,81,27,108,2.7191424545945235,Hawkish
탕자/NNG,29,1,30,26.28504372774706,Hawkish
개방형펀드/NNG,28,3,31,8.459554303182962,Hawkish
장시/NNG,236,163,399,1.3123059699065593,Hawkish
수분/NNG,14,6,20,2.1148885757957405,Hawkish
잠시/NNG,17,9,26,1.7120526565965517,Hawkish
물가/NNG;금융안정/NNG,27,9,36,2.7191424545945235,Hawkish
순이자이익/NNG,54,9,63,5.438284909189047,Hawkish
불변/NNG,34,20,54,1.5408473909368965,Hawkish
미분양/NNG,787,119,906,5.994300032957675,Hawkish
조각/NNG,21,7,28,2.7191424545945235,Hawkish
빡빡/NNG,13,5,18,2.3565901273152536,Hawkish
근원/NNG;인플레이션/NNG;높/VA,13,4,17,2.9457376591440667,Hawkish
환경/NNG;녹록/NNG;않/VX,16,7,23,2.0717275844529706,Hawkish
개선/NNG;더디/VA,17,11,28,1.4007703553971786,Hawkish
투자심리/NNG;살/VV,19,11,30,1.5655668677968468,Hawkish
과실/NNG,23,12,35,1.737229901546501,Hawkish
관리자/NNG,22,12,34,1.661698166696653,Hawkish
매달/NNG,24,8,32,2.719142454594523,Hawkish
물별/NNG,41,16,57,2.322600846632822,Hawkish
피벗/NNG,286,146,432,1.7755131096210814,Hawkish
프로퍼티/NNG,16,8,24,1.8127616363963488,Hawkish
차선/NNG,26,9,35,2.618433474794726,Hawkish
뱅커/NNG,16,4,20,3.6255232727926976,Hawkish
재생에너지/NNG,197,72,269,2.479958627570005,Hawkish
부동산/NNG;가격/NNG;급등/NNG,18,9,27,1.812761636396349,Hawkish
임금/NNG;상승률/NNG;하락/NNG,12,7,19,1.5537956883397277,Hawkish
수출/NNG;양호/NNG,22,14,36,1.424312714311417,Hawkish
저항선/NNG,151,97,248,1.410963954102313,Hawkish
쪼그라들/VV,13,9,22,1.309216737397363,Hawkish
망하/VV,21,6,27,3.1723328636936103,Hawkish
깜짝/MAG;성장/NNG,42,8,50,4.758499295540416,Hawkish
순부채비율/NNG,14,4,18,3.1723328636936103,Hawkish
소비자/NNG;물가/NNG;상승률/NNG;둔화/NNG,28,15,43,1.6919108606365922,Hawkish
내건/VV,11,7,18,1.424312714311417,Hawkish
찜찜/NNG,14,9,23,1.4099257171971604,Hawkish
상향/NNG;위험/NNG,13,6,19,1.9638251060960445,Hawkish
금리/NNG;인하/NNG;미루/VV,56,37,93,1.3718196167323722,Hawkish
피봇/NNG,159,56,215,2.573474108812674,Hawkish
상승률/NNG;상승/NNG,16,9,25,1.6113436767967546,Hawkish
글로벌/NNG;경기/NNG;둔화/NNG,54,35,89,1.398416119505755,Hawkish
작음/NNG,14,7,21,1.812761636396349,Hawkish
연율환산/NNG,40,12,52,3.021269393993915,Hawkish
안정/NNG;하향/NNG,13,9,22,1.309216737397363,Hawkish
티티티/NNG,21,11,32,1.7303633801965148,Hawkish
국제/NNG;금융시장/NNG;불안/NNG,13,9,22,1.309216737397363,Hawkish
블랙아웃/NNG,88,58,146,1.375198482783437,Hawkish
민원/NNG,73,25,98,2.6466319891386694,Hawkish
수입/NNG;물가/NNG;오르/VV,12,6,18,1.8127616363963488,Hawkish
박박/MAG,17,6,23,2.5680789848948273,Hawkish
지닌다/VV,18,7,25,2.3306935325095917,Hawkish
정부채/NNG,247,153,400,1.4632422359147002,Hawkish
환금성/NNG,21,9,30,2.1148885757957405,Hawkish
높/VA;임금/NNG;상승/NNG,11,6,17,1.661698166696653,Hawkish
소비자/NNG;물가/NNG;상승률/NNG;높/VA,17,3,20,5.136157969789655,Hawkish
버틸/VV,58,34,92,1.5461790428086506,Hawkish
점인/NNG,22,15,37,1.3293585333573226,Hawkish
알아보/VV,21,13,34,1.464153629397051,Hawkish
성장/NNG;경로/NNG;불확실성/NNG,16,10,26,1.4502093091170791,Hawkish
감자/NNG,31,19,50,1.4788318612707056,Hawkish
울울/NNG,26,13,39,1.8127616363963488,Hawkish
여주/NNG,19,10,29,1.7221235545765314,Hawkish
물가/NNG;상향/NNG,30,16,46,1.699464034121577,Hawkish
토로/NNG,27,16,43,1.5295176307094194,Hawkish
원가/NNG,281,167,448,1.5251078437945331,Hawkish
오래/MAG,543,336,879,1.4647761436952642,Hawkish
채용/NNG,162,110,272,1.3348517504373116,Hawkish
긴축/NNG;부담/NNG,31,18,49,1.560989186896856,Hawkish
전부/NNG,44,25,69,1.5952302400287868,Hawkish
기대/NNG;인플레이션/NNG;하락/NNG,52,32,84,1.4728688295720334,Hawkish
우선/NNG,97,57,154,1.5424375327232092,Hawkish
전망/NNG;영향/NNG;줄/VV,18,1,19,16.31485472756714,Hawkish
신용등급/NNG;부정적/VAX,21,13,34,1.464153629397051,Hawkish
양당/NNG,69,46,115,1.3595712272972618,Hawkish
할당관세/NNG,18,3,21,5.438284909189047,Hawkish
유통비중/NNG,18,5,23,3.262970945513428,Hawkish
고물/NNG,16,8,24,1.8127616363963488,Hawkish
컨틴전시플랜/NNG,23,2,25,10.423379409279006,Hawkish
경상/NNG;수지/NNG;악화/NNG,15,6,21,2.265952045495436,Hawkish
경제/NNG;활동/NNG;둔화/NNG,17,10,27,1.5408473909368965,Hawkish
흑자전환/NNG;성공/NNG,20,13,33,1.3944320279971913,Hawkish
심각/NNG;우려/NNG,38,7,45,4.920353013075804,Hawkish
기차/NNG,33,9,42,3.323396333393307,Hawkish
비금속/NNG,37,19,56,1.765057382806971,Hawkish
다급/NNG,18,6,24,2.7191424545945235,Hawkish
기습/NNG,32,15,47,1.9336124121561056,Hawkish
지수/NNG;혼조/NNG,20,10,30,1.812761636396349,Hawkish
행순/NNG,26,15,41,1.5710600848768357,Hawkish
비고/NNG,434,290,724,1.3564457762000266,Hawkish
남구/NNG,38,13,51,2.6494208531946635,Hawkish
위험/NNG;회피/NNG;강화/NNG,24,11,35,1.977558148796017,Hawkish
전망/NNG;물가/NNG;안정/NNG,12,8,20,1.3595712272972615,Hawkish
힘쓸/VV,11,7,18,1.424312714311417,Hawkish
기술적분석/NNG,17,11,28,1.4007703553971786,Hawkish
유스/NNG,18,9,27,1.812761636396349,Hawkish
만드/VV,150,102,252,1.332912967938492,Hawkish
대출기업/NNG,28,9,37,2.819851434394321,Hawkish
기대/NNG;약화/NNG,60,38,98,1.431127607681328,Hawkish
경제/NNG;하방/NNG;압력/NNG,11,6,17,1.661698166696653,Hawkish
소득세/NNG,239,118,357,1.8358052165200314,Hawkish
마지노선/NNG,29,18,47,1.460280207097059,Hawkish
진실/NNG,38,12,50,2.870205924294219,Hawkish
위험자산/NNG;선호/NNG;약화/NNG,13,6,19,1.9638251060960445,Hawkish
메디컬/NNG,30,13,43,2.091648041995787,Hawkish
불사/NNG,20,5,25,3.625523272792698,Hawkish
성장국면/NNG,25,15,40,1.5106346969969575,Hawkish
스톱/NNG,54,20,74,2.447228209135071,Hawkish
재정/NNG;적자/NNG;증가/NNG,14,9,23,1.4099257171971604,Hawkish
큰정부/NNG,15,5,20,2.719142454594523,Hawkish
단기성/NNG,175,62,237,2.558332954591621,Hawkish
문전/NNG,14,7,21,1.812761636396349,Hawkish
현금/NNG;확보/NNG,37,25,62,1.3414436109332981,Hawkish
보급/NNG,95,56,151,1.537610316586189,Hawkish
굉굉/NNG,21,1,22,19.033997182161663,Hawkish
원천징수/NNG,26,12,38,1.9638251060960445,Hawkish
상승률/NNG;하락/NNG,30,6,36,4.531904090990872,Hawkish
재재/MAG,39,22,61,1.606765995896764,Hawkish
청산결제/NNG,18,3,21,5.438284909189047,Hawkish
널널/NNG,15,3,18,4.531904090990872,Hawkish
블랙먼데이/NNG,12,5,17,2.1753139636756185,Hawkish
유동성/NNG;위축/NNG,20,12,32,1.5106346969969575,Hawkish
대출/NNG;축소/NNG,26,12,38,1.9638251060960445,Hawkish
자금/NNG;조달/NNG;비용/NNG;증가/NNG,17,6,23,2.5680789848948273,Hawkish
종착지/NNG,14,9,23,1.4099257171971604,Hawkish
든든/NNG,64,36,100,1.6113436767967546,Hawkish
전망/NNG;밑돌/VV,30,17,47,1.5994955615261899,Hawkish
예정이율/NNG,92,2,94,41.693517637116024,Hawkish
소리/NNG,46,27,73,1.544204356930223,Hawkish
똑같/VA,22,13,35,1.5338752307969103,Hawkish
금리/NNG;낙폭/NNG;확대/NNG,31,19,50,1.4788318612707056,Hawkish
기업분석/NNG,97,43,140,2.0446264968656496,Hawkish
정책/NNG;지지/NNG,12,5,17,2.1753139636756185,Hawkish
중개업소/NNG,19,12,31,1.4351029621471094,Hawkish
수요예측/NNG;흥행/NNG;성공/NNG,16,9,25,1.6113436767967546,Hawkish
판매가격/NNG;상승/NNG,13,8,21,1.4728688295720334,Hawkish
금리/NNG;인상/NNG;종료/NNG,74,36,110,1.8631161262962475,Hawkish
파동/NNG,27,11,38,2.224752917395519,Hawkish
정렬/NNG,22,5,27,3.988075600071967,Hawkish
수성/NNG,32,13,45,2.2310912447955062,Hawkish
들어옴/VV,13,4,17,2.9457376591440667,Hawkish
실업자/NNG,194,93,287,1.8907298788219984,Hawkish
입양/NNG,13,6,19,1.9638251060960445,Hawkish
매주/MAG,17,11,28,1.4007703553971786,Hawkish
유사점/NNG,17,9,26,1.7120526565965517,Hawkish
로스쿨/NNG,17,4,21,3.852118477342241,Hawkish
통화/NNG;긴축/NNG,175,99,274,1.602188314996773,Hawkish
정치/NNG;불확실성/NNG;완화/NNG,13,4,17,2.9457376591440667,Hawkish
대담/NNG,130,85,215,1.3862294866560314,Hawkish
다루/VV,53,31,84,1.549618818209782,Hawkish
제하/NNG,27,13,40,1.8824832377962084,Hawkish
안보/NNG,128,88,216,1.3183720991973447,Hawkish
실탄/NNG,40,8,48,4.5319040909908725,Hawkish
물가/NNG;상승/NNG;가속/NNG,16,3,19,4.834031030390264,Hawkish
공포/NNG,208,85,293,2.2179671786496504,Hawkish
부드럽/VA,12,8,20,1.3595712272972615,Hawkish
벌거벗/VV,18,1,19,16.31485472756714,Hawkish
관해서/VV,43,17,60,2.2926103048542057,Hawkish
금리/NNG;되돌/VV,46,28,74,1.4890542013255725,Hawkish
환하/VA,34,22,56,1.4007703553971786,Hawkish
무화/NNG,55,30,85,1.661698166696653,Hawkish
투자/NNG;부진/NNG,28,19,47,1.3357191005025728,Hawkish
하나/NNG,13,4,17,2.9457376591440667,Hawkish
수입/NNG;늘/VV,15,10,25,1.3595712272972615,Hawkish
객관/NNG,40,25,65,1.4502093091170791,Hawkish
허물/VV,13,4,17,2.9457376591440667,Hawkish
상승률/NNG;내리/VV,14,4,18,3.1723328636936103,Hawkish
우려/NNG;줄/VV,26,16,42,1.4728688295720334,Hawkish
산탄데르은행/NNG,11,7,18,1.424312714311417,Hawkish
장마/VV,19,2,21,8.610617772882657,Hawkish
하향/NNG;등급/NNG;하향/NNG,13,7,20,1.6832786623680382,Hawkish
본토/NNG,194,114,308,1.5424375327232092,Hawkish
한미/NNG;금리/NNG;역전폭/NNG;확대/NNG,16,10,26,1.4502093091170791,Hawkish
환전/NNG,62,32,94,1.756112835258963,Hawkish
건당/NNG,18,9,27,1.812761636396349,Hawkish
주택비중/NNG,25,2,27,11.32976022747718,Hawkish
가격/NNG;모멘텀/NNG,15,4,19,3.398928068243154,Hawkish
임시직/NNG,49,19,68,2.3375084258795025,Hawkish
재정계획/NNG,13,6,19,1.9638251060960445,Hawkish
출자금/NNG,26,18,44,1.309216737397363,Hawkish
액체/NNG,22,13,35,1.5338752307969103,Hawkish
건의/NNG,36,19,55,1.7173531292175939,Hawkish
블링/NNG,17,3,20,5.136157969789655,Hawkish
인플레이션/NNG;불확실성/NNG,34,18,52,1.7120526565965517,Hawkish
fed/NNG;매파/NNG,324,198,522,1.4831686115970129,Hawkish
대출자산/NNG,123,81,204,1.3763560572638946,Hawkish
역축/NNG,242,159,401,1.3795230063142028,Hawkish
물가/NNG;긴축/NNG,14,7,21,1.812761636396349,Hawkish
해해해/MAG,25,15,40,1.5106346969969575,Hawkish
해고/NNG,189,99,288,1.730363380196515,Hawkish
중대형/NNG,33,22,55,1.3595712272972618,Hawkish
긴축/NNG;경계/NNG;완화/NNG,13,9,22,1.309216737397363,Hawkish
가격/NNG;압력/NNG,25,9,34,2.5177244949949293,Hawkish
연고/NNG,12,7,19,1.5537956883397277,Hawkish
재정법/NNG,16,7,23,2.0717275844529706,Hawkish
개수/NNG,31,21,52,1.3379907316258763,Hawkish
물가/NNG;상승/NNG;둔화/NNG,82,53,135,1.4023250394764206,Hawkish
농축수산물/NNG,233,134,367,1.5760203779117512,Hawkish
이혼/NNG,14,6,20,2.1148885757957405,Hawkish
토건/NNG,13,4,17,2.9457376591440667,Hawkish
조정장/NNG,19,10,29,1.7221235545765314,Hawkish
해상/NNG,70,38,108,1.6696488756282162,Hawkish
수출/NNG;증가/NNG,101,69,170,1.3267313425799365,Hawkish
고정비/NNG;부담/NNG,24,12,36,1.8127616363963488,Hawkish
앞당기/VV,235,155,390,1.3741902727520712,Hawkish
유통통화/NNG,132,80,212,1.495528350026988,Hawkish
재점검/NNG,45,25,70,1.6314854727567139,Hawkish
부동산/NNG;경기/NNG;하락/NNG,12,5,17,2.1753139636756185,Hawkish
자산부채/NNG,259,113,372,2.0774569195869663,Hawkish
돋보일/VV,11,7,18,1.424312714311417,Hawkish
국고채/NNG;발행/NNG;증가/NNG,16,10,26,1.4502093091170791,Hawkish
스왑레이트/NNG;하락/NNG,13,8,21,1.4728688295720334,Hawkish
징후/NNG,243,168,411,1.3110151120366451,Hawkish
선고/NNG,26,16,42,1.4728688295720334,Hawkish
봐서/VV,23,14,37,1.4890542013255725,Hawkish
머크/NNG,24,10,34,2.1753139636756185,Hawkish
갈무리/NNG,16,9,25,1.6113436767967546,Hawkish
단축/NNG,80,48,128,1.5106346969969575,Hawkish
범야/NNG,18,7,25,2.3306935325095917,Hawkish
제3자배정/NNG,13,7,20,1.6832786623680382,Hawkish
중흥/NNG,15,5,20,2.719142454594523,Hawkish
이피/NNG,33,19,52,1.574240368449461,Hawkish
등급평가/NNG,21,12,33,1.5861664318468052,Hawkish
분할매수/NNG,100,40,140,2.2659520454954363,Hawkish
후장/NNG,18,11,29,1.4831686115970129,Hawkish
조류/NNG,76,9,85,7.6538824647845844,Hawkish
채권시장/NNG;우려/NNG,16,11,27,1.3183720991973447,Hawkish
덜/MAG;매파/NNG,15,8,23,1.699464034121577,Hawkish
자동차보험료/NNG,36,14,50,2.3306935325095917,Hawkish
육군/NNG,23,6,29,3.474459803093002,Hawkish
높/VA;하락/NNG,16,10,26,1.4502093091170791,Hawkish
맞물릴/VV,25,9,34,2.5177244949949293,Hawkish
영토/NNG,61,21,82,2.6328204719089827,Hawkish
원유/NNG;수요/NNG;감소/NNG,13,6,19,1.9638251060960445,Hawkish
내수/NNG;확대/NNG,14,6,20,2.1148885757957405,Hawkish
역습/NNG,21,14,35,1.3595712272972618,Hawkish
식품기업/NNG,15,5,20,2.719142454594523,Hawkish
주머니/NNG,12,6,18,1.8127616363963488,Hawkish
청구자/NNG,140,52,192,2.4402560489950846,Hawkish
기분/NNG,24,12,36,1.8127616363963488,Hawkish
칸다/VV,20,6,26,3.021269393993915,Hawkish
소득세법/NNG,14,5,19,2.5378662909548884,Hawkish
재형/NNG,109,32,141,3.0873596619875316,Hawkish
감축목표/NNG,24,13,37,1.6733184335966296,Hawkish
조건부/NNG,284,196,480,1.3133273080014365,Hawkish
주식회사/NNG,61,13,74,4.253017685391434,Hawkish
챌린저/NNG,30,15,45,1.8127616363963488,Hawkish
강하/VA;긴축/NNG,40,16,56,2.2659520454954363,Hawkish
획기적으로/MAG,17,9,26,1.7120526565965517,Hawkish
둘지/VV,12,6,18,1.8127616363963488,Hawkish
내국인/NNG,25,17,42,1.332912967938492,Hawkish
냉각/NNG,138,82,220,1.5253725964798548,Hawkish
주택/NNG;경기/NNG;부진/NNG,13,7,20,1.6832786623680382,Hawkish
월별/NNG,441,270,711,1.480422003057018,Hawkish
내수/NNG;모멘텀/NNG,14,4,18,3.1723328636936103,Hawkish
최종재/NNG,16,10,26,1.4502093091170791,Hawkish
퇴직/NNG,61,41,102,1.3485178026850888,Hawkish
찬바람/NNG,16,10,26,1.4502093091170791,Hawkish
부동산/NNG;pf/NNG;부실/NNG;우려/NNG,19,12,31,1.4351029621471094,Hawkish
수출/NNG;견조/NNG,16,10,26,1.4502093091170791,Hawkish
전망/NNG;어렵/VA,12,8,20,1.3595712272972615,Hawkish
업무지구/NNG,13,7,20,1.6832786623680382,Hawkish
마감일/NNG,15,7,22,1.9422446104246596,Hawkish
대출/NNG;증가/NNG;둔화/NNG,28,9,37,2.819851434394321,Hawkish
미침/VV,37,22,59,1.5243677396969297,Hawkish
잠재/NNG;성장/NNG,30,18,48,1.5106346969969573,Hawkish
후계/NNG,23,9,32,2.3163065353953347,Hawkish
안정성/NNG;개선/NNG,12,8,20,1.3595712272972615,Hawkish
입법/NNG,83,49,132,1.5352981206213976,Hawkish
시퀘스터/NNG,68,6,74,10.27231593957931,Hawkish
공습/NNG,195,81,276,2.182027895662272,Hawkish
회전기/NNG,29,1,30,26.28504372774706,Hawkish
분양대금/NNG,19,11,30,1.5655668677968468,Hawkish
저장/NNG,81,54,135,1.3595712272972618,Hawkish
약국/NNG,41,22,63,1.689164252096598,Hawkish
공시기준/NNG,42,24,66,1.5861664318468052,Hawkish
고교/NNG,12,5,17,2.1753139636756185,Hawkish
가격/NNG;위험/NNG,13,6,19,1.9638251060960445,Hawkish
치도/NNG,13,5,18,2.3565901273152536,Hawkish
제조업/NNG;위축/NNG,22,9,31,2.2155975555955374,Hawkish
상호저축은행/NNG,57,29,86,1.781507125423998,Hawkish
오해/NNG,59,38,97,1.4072754808866392,Hawkish
다중채무자/NNG,49,19,68,2.3375084258795025,Hawkish
외시/NNG,18,7,25,2.3306935325095917,Hawkish
인플레이션/NNG;지표/NNG;둔화/NNG,16,8,24,1.8127616363963488,Hawkish
살아남/VV,26,18,44,1.309216737397363,Hawkish
동반자/NNG,12,7,19,1.5537956883397277,Hawkish
거래금액/NNG,459,318,777,1.3082666526822706,Hawkish
상담/NNG,42,26,68,1.464153629397051,Hawkish
전차/NNG,19,4,23,4.3053088864413285,Hawkish
녹색금융/NNG,49,24,73,1.8505275038212727,Hawkish
공직자/NNG,23,9,32,2.3163065353953347,Hawkish
통화정책/NNG;불확실성/NNG;높/VA,12,6,18,1.8127616363963488,Hawkish
신계약비/NNG,16,2,18,7.251046545585395,Hawkish
케어/NNG,47,22,69,1.9363590206961,Hawkish
분기점/NNG,26,16,42,1.4728688295720334,Hawkish
돌려놓/VV,11,6,17,1.661698166696653,Hawkish
돌연/MAG,42,10,52,3.8067994364323328,Hawkish
전경련/NNG,14,9,23,1.4099257171971604,Hawkish
밀레니얼세대/NNG,32,13,45,2.2310912447955062,Hawkish
언덕/NNG,13,9,22,1.309216737397363,Hawkish
경매시장/NNG,12,5,17,2.1753139636756185,Hawkish
메디케이드/NNG,16,10,26,1.4502093091170791,Hawkish
신용카드사/NNG,50,26,76,1.7430400349964892,Hawkish
강력히/MAG,31,18,49,1.560989186896856,Hawkish
해설/NNG,15,9,24,1.5106346969969573,Hawkish
월부/NNG,39,17,56,2.079344229984047,Hawkish
주권/NNG,45,17,62,2.399243342289285,Hawkish
고정이하여신비율/NNG,149,73,222,1.8500101631716164,Hawkish
위태/NNG,34,21,55,1.467473705654187,Hawkish
지루/NNG,25,16,41,1.4162200284346476,Hawkish
공자/NNG,16,6,22,2.417015515195132,Hawkish
실적/NNG;양호/NNG,27,10,37,2.447228209135071,Hawkish
포스트/NNG,82,50,132,1.486464541845006,Hawkish
통화/NNG;증가/NNG,24,15,39,1.4502093091170791,Hawkish
진도/NNG,95,31,126,2.7776186364137603,Hawkish
도착/NNG,42,25,67,1.522719774572933,Hawkish
심심/NNG,192,129,321,1.349031915457748,Hawkish
야성적충동/NNG,16,1,17,14.50209309117079,Hawkish
사무실/NNG,80,31,111,2.3390472727694824,Hawkish
과도/NNG;스프레드/NNG;축소/NNG,15,4,19,3.398928068243154,Hawkish
근원/NNG;pce/NNG;물가/NNG;오르/VV,13,6,19,1.9638251060960445,Hawkish
탄소중립/NNG,135,77,212,1.5891092267110851,Hawkish
fed/NNG;매파/NNG;통화/NNG;긴축/NNG;선호/NNG,53,25,78,1.9215273345801298,Hawkish
높/VA;재무/NNG;부담/NNG,12,5,17,2.1753139636756185,Hawkish
랜드/NNG,32,22,54,1.3183720991973447,Hawkish
하하하하/MAG,28,15,43,1.6919108606365922,Hawkish
수일/NNG,19,7,26,2.460176506537902,Hawkish
단리/NNG,89,39,128,2.068407508195834,Hawkish
회견/NNG,70,17,87,3.732156310227777,Hawkish
이칭/NNG,17,5,22,3.081694781873793,Hawkish
빅스/NNG,44,11,55,3.6255232727926976,Hawkish
금리/NNG;전고점/NNG,12,8,20,1.3595712272972615,Hawkish
금리/NNG;하락/NNG;압력/NNG,46,30,76,1.389783921237201,Hawkish
완만/NNG;금리/NNG;상승/NNG,14,8,22,1.5861664318468052,Hawkish
총자산회전율/NNG,20,13,33,1.3944320279971913,Hawkish
인상/NNG;인하/NNG;인상/NNG,14,8,22,1.5861664318468052,Hawkish
올올/MAG,53,9,62,5.33757592938925,Hawkish
황이/NNG,26,15,41,1.5710600848768357,Hawkish
최대금액/NNG,11,6,17,1.661698166696653,Hawkish
자수/NNG,450,310,760,1.315714090932834,Hawkish
직책/NNG,94,46,140,1.8521694980571393,Hawkish
투자성향/NNG,45,23,68,1.7733537747355588,Hawkish
fed/NNG;금리/NNG;인상/NNG;종료/NNG,35,21,56,1.5106346969969573,Hawkish
실성/NNG,33,22,55,1.3595712272972618,Hawkish
품목/NNG,587,386,973,1.378356321974944,Hawkish
려로/NNG,15,9,24,1.5106346969969573,Hawkish
당년/NNG,15,2,17,6.797856136486308,Hawkish
주관사/NNG,626,435,1061,1.304354924579442,Hawkish
부족액/NNG,38,12,50,2.870205924294219,Hawkish
시야/NNG,33,17,50,1.7594451176788093,Hawkish
맞춤/VV,14,7,21,1.812761636396349,Hawkish
국채입찰/NNG;호조/NNG,20,10,30,1.812761636396349,Hawkish
총통/NNG,36,9,45,3.625523272792698,Hawkish
회자/NNG,31,18,49,1.560989186896856,Hawkish
전설/NNG,20,8,28,2.2659520454954363,Hawkish
특별회계/NNG,27,9,36,2.7191424545945235,Hawkish
주택/NNG;대출/NNG;증가/NNG,25,7,32,3.237074350707766,Hawkish
금방/MAG,21,11,32,1.7303633801965148,Hawkish
발톱/NNG,16,7,23,2.0717275844529706,Hawkish
공급계획/NNG,13,4,17,2.9457376591440667,Hawkish
유류/NNG,24,13,37,1.6733184335966296,Hawkish
좀비기업/NNG,52,11,63,4.28470932239137,Hawkish
특이점/NNG,14,9,23,1.4099257171971604,Hawkish
목표제/NNG,96,59,155,1.4747891279156735,Hawkish
저감/NNG,28,11,39,2.3071511735953534,Hawkish
외국인지분율/NNG,27,9,36,2.7191424545945235,Hawkish
이체/NNG,40,27,67,1.3427863973306289,Hawkish
청구/NNG,90,54,144,1.5106346969969573,Hawkish
비수기/NNG,72,46,118,1.418683019788447,Hawkish
금리/NNG;밀/VV;오르/VV,15,8,23,1.699464034121577,Hawkish
장마/NNG,52,26,78,1.8127616363963488,Hawkish
암호/NNG,15,4,19,3.398928068243154,Hawkish
인원/NNG,88,59,147,1.3518900339227007,Hawkish
질의/NNG,158,91,249,1.5737161458825446,Hawkish
확고히/MAG,42,11,53,3.4607267603930296,Hawkish
덕분/NNG,147,93,240,1.432666454571308,Hawkish
채용계획/NNG,26,5,31,4.713180254630507,Hawkish
긴축/NNG;우려/NNG,65,45,110,1.3092167373973629,Hawkish
투자비/NNG,19,12,31,1.4351029621471094,Hawkish
토빈세/NNG,54,16,70,3.0590352614188387,Hawkish
방위비/NNG,12,7,19,1.5537956883397277,Hawkish
세수/NNG,567,247,814,2.080639368090546,Hawkish
통화정책/NNG;불확실성/NNG;확대/NNG,15,6,21,2.265952045495436,Hawkish
주유소/NNG,57,32,89,1.6144908324154983,Hawkish
소비/NNG;증가/NNG,51,35,86,1.3207263350887684,Hawkish
z세대/NNG,40,12,52,3.021269393993915,Hawkish
정식/NNG,42,19,61,2.0035786507538593,Hawkish
국세청/NNG,20,12,32,1.5106346969969575,Hawkish
스핀/NNG,14,4,18,3.1723328636936103,Hawkish
라이트/NNG,15,8,23,1.699464034121577,Hawkish
물러난/VV,13,9,22,1.309216737397363,Hawkish
에스에프/NNG,13,5,18,2.3565901273152536,Hawkish
기대/NNG;확대/NNG,63,39,102,1.464153629397051,Hawkish
도발/NNG,76,33,109,2.0874224903957956,Hawkish
승연/NNG,27,15,42,1.631485472756714,Hawkish
스왑레이트/NNG,146,94,240,1.4077829729461007,Hawkish
인하/NNG;기대/NNG;차단/NNG,25,14,39,1.618537175353883,Hawkish
속도조절/NNG,689,339,1028,1.8421722234175288,Hawkish
채발/NNG,137,76,213,1.6338706854361829,Hawkish
기대/NNG;인플레이션/NNG;높/VA,47,20,67,2.12999492276571,Hawkish
성패/NNG,12,8,20,1.3595712272972615,Hawkish
장기추세/NNG,138,57,195,2.1943956651113696,Hawkish
내수/NNG;둔화/NNG,26,17,43,1.3862294866560314,Hawkish
구차/NNG,70,42,112,1.5106346969969573,Hawkish
물가/NNG;금리/NNG;인상/NNG,12,7,19,1.5537956883397277,Hawkish
물가/NNG;상방/NNG,18,11,29,1.4831686115970129,Hawkish
시공/NNG,73,49,122,1.3503224434380967,Hawkish
지표/NNG;둔화/NNG,61,41,102,1.3485178026850888,Hawkish
국방/NNG,106,67,173,1.4339756228209926,Hawkish
점포/NNG,61,38,99,1.454979734476017,Hawkish
자세히/MAG,36,16,52,2.0393568409458926,Hawkish
인플레이션/NNG;우려/NNG;크/VV,20,11,31,1.647965123996681,Hawkish
밑돈/NNG,100,40,140,2.2659520454954363,Hawkish
분양률/NNG,105,32,137,2.97406205971276,Hawkish
가계/NNG;대출/NNG;높/VA;증가/NNG,14,5,19,2.5378662909548884,Hawkish
위탁관리/NNG,47,10,57,4.25998984553142,Hawkish
통화정책/NNG;불확실성/NNG,56,32,88,1.5861664318468052,Hawkish
코발트/NNG,32,4,36,7.251046545585395,Hawkish
간간/NNG,323,131,454,2.234816826549697,Hawkish
전망/NNG;불확실성/NNG;높/VA,43,15,58,2.5982916788347667,Hawkish
근근/MAG,199,100,299,1.8036978282143672,Hawkish
속보/NNG,146,90,236,1.4703511050770384,Hawkish
역임/NNG,48,31,79,1.4034283636616893,Hawkish
파고/NNG,117,63,180,1.6832786623680382,Hawkish
석유기업/NNG,26,12,38,1.9638251060960445,Hawkish
부정부패/NNG,13,8,21,1.4728688295720334,Hawkish
트렌드분석/NNG,24,1,25,21.753139636756185,Hawkish
세목/NNG,25,4,29,5.66488011373859,Hawkish
미/NNG;fed/NNG;매파/NNG,31,9,40,3.121978373793712,Hawkish
한하/VV,611,403,1014,1.3741902727520712,Hawkish
퀀트/NNG,50,24,74,1.8882933712461967,Hawkish
본예산/NNG,43,17,60,2.2926103048542057,Hawkish
인상기/NNG,437,270,707,1.466994139083712,Hawkish
띄우/VV,18,11,29,1.4831686115970129,Hawkish
fed/NNG;긴축/NNG;우려/NNG,19,8,27,2.1526544432206642,Hawkish
부동/NNG,131,75,206,1.5831451624528112,Hawkish
누락/NNG,13,5,18,2.3565901273152536,Hawkish
인플레이션/NNG;억제/NNG,52,17,69,2.772458973312063,Hawkish
인상/NNG;효과/NNG,82,56,138,1.327200483790184,Hawkish
재매입/NNG,23,8,31,2.6058448523197515,Hawkish
소매/NNG;판매/NNG;부진/NNG,26,13,39,1.8127616363963488,Hawkish
브루킹스연구소/NNG,13,9,22,1.309216737397363,Hawkish
입찰공고/NNG,17,1,18,15.408473909368965,Hawkish
긴축/NNG;효과/NNG,100,43,143,2.1078623679027313,Hawkish
금융거래세/NNG,26,5,31,4.713180254630507,Hawkish
불불/MAG,180,100,280,1.6314854727567139,Hawkish
롱심리/NNG,29,19,48,1.3834233540919505,Hawkish
산원/NNG,89,34,123,2.3725850829305153,Hawkish
인플레이션갭/NNG,141,87,228,1.4689620157004897,Hawkish
벌어들인/VV,31,13,44,2.1613696433956466,Hawkish
盲人/NNG,31,1,32,28.097805364143408,Hawkish
리스크오프/NNG,19,13,32,1.3247104265973317,Hawkish
엑손/NNG,16,9,25,1.6113436767967546,Hawkish
인상/NNG;파급효과/NNG,53,31,84,1.549618818209782,Hawkish
인인/NNG,1977,892,2869,2.008873181141021,Hawkish
순항미사일/NNG,18,12,30,1.3595712272972618,Hawkish
나온다는/VV,11,7,18,1.424312714311417,Hawkish
유동성/NNG;축소/NNG,39,23,62,1.5369066047708175,Hawkish
보험증권/NNG,24,15,39,1.4502093091170791,Hawkish
감감/NNG,24,16,40,1.3595712272972615,Hawkish
약본/NNG,46,8,54,5.211689704639503,Hawkish
소매/NNG;판매/NNG;감소/NNG,20,8,28,2.2659520454954363,Hawkish
물가/NNG;상승률/NNG;오르/VV,12,6,18,1.8127616363963488,Hawkish
평화협정/NNG,14,4,18,3.1723328636936103,Hawkish
양가/NNG,16,2,18,7.251046545585395,Hawkish
높/VA;인하/NNG,24,10,34,2.1753139636756185,Hawkish
인질/NNG,22,11,33,1.8127616363963488,Hawkish
유통망/NNG,13,4,17,2.9457376591440667,Hawkish
경기/NNG;지표/NNG;개선/NNG,15,9,24,1.5106346969969573,Hawkish
긴축/NNG,6192,3587,9779,1.5646250421753822,Hawkish
화인/NNG,11,6,17,1.661698166696653,Hawkish
역송금/NNG,64,36,100,1.6113436767967546,Hawkish
위험/NNG;아니/VCN,18,10,28,1.631485472756714,Hawkish
계절/NNG,25,7,32,3.237074350707766,Hawkish
둔화/NNG;우려/NNG,26,6,32,3.927650212192089,Hawkish
엘에스엠/NNG,92,54,146,1.544204356930223,Hawkish
국도/NNG,29,19,48,1.3834233540919505,Hawkish
신용시장/NNG,103,68,171,1.3729003569766465,Hawkish
걸리/VV,564,258,822,1.9813906258285674,Hawkish
청담/NNG,20,3,23,6.04253878798783,Hawkish
준공/NNG,326,95,421,3.1103173340274193,Hawkish
경영인/NNG,11,6,17,1.661698166696653,Hawkish
건설/NNG;안정/NNG,13,4,17,2.9457376591440667,Hawkish
표한/VV,18,11,29,1.4831686115970129,Hawkish
강하/VA;매파/NNG,12,7,19,1.5537956883397277,Hawkish
자산/NNG;축소/NNG,51,35,86,1.3207263350887684,Hawkish
유가상승/NNG,98,61,159,1.4561527898921491,Hawkish
버튼/NNG,12,7,19,1.5537956883397277,Hawkish
주택보급률/NNG,16,1,17,14.50209309117079,Hawkish
공공요금/NNG;인상/NNG,50,21,71,2.1580495671385105,Hawkish
인상/NNG;배제/NNG,14,9,23,1.4099257171971604,Hawkish
물가/NNG;우려/NNG;완화/NNG,12,5,17,2.1753139636756185,Hawkish
식료품/NNG;가격/NNG;상승/NNG,12,5,17,2.1753139636756185,Hawkish
내수/NNG;부진/NNG,107,63,170,1.5394086912254707,Hawkish
신화/NNG,38,26,64,1.3247104265973317,Hawkish
수위/NNG,91,58,149,1.4220802492419633,Hawkish
침체/NNG;우려/NNG,19,13,32,1.3247104265973317,Hawkish
전망/NNG;부진/NNG,21,9,30,2.1148885757957405,Hawkish
적기시정조치/NNG,15,9,24,1.5106346969969573,Hawkish
연안/NNG,15,8,23,1.699464034121577,Hawkish
이해관계자/NNG,55,36,91,1.384748472247211,Hawkish
물가/NNG;상승/NNG;압력/NNG;완화/NNG,21,12,33,1.5861664318468052,Hawkish
정수/NNG,13,5,18,2.3565901273152536,Hawkish
푸르/VA,17,11,28,1.4007703553971786,Hawkish
운송장/NNG,32,21,53,1.3811517229686467,Hawkish
대여금/NNG,43,12,55,3.2478645985434587,Hawkish
일러/VV,37,19,56,1.765057382806971,Hawkish
인접/NNG,24,13,37,1.6733184335966296,Hawkish
석상/NNG,26,10,36,2.3565901273152536,Hawkish
복기/NNG,57,32,89,1.6144908324154983,Hawkish
걸걸/MAG,12,8,20,1.3595712272972615,Hawkish
체로/NNG,27,12,39,2.0393568409458926,Hawkish
의무비율/NNG,18,1,19,16.31485472756714,Hawkish
커버리지/NNG,204,103,307,1.7951620088585203,Hawkish
원화/NNG;상승/NNG,15,8,23,1.699464034121577,Hawkish
높/VA;인플레이션/NNG;압력/NNG,20,9,29,2.0141795959959437,Hawkish
유암/NNG,21,5,26,3.8067994364323328,Hawkish
경공/NNG,21,8,29,2.379249647770208,Hawkish
채권시장/NNG;지정학/NNG;위험/NNG,13,4,17,2.9457376591440667,Hawkish
비연/NNG,24,15,39,1.4502093091170791,Hawkish
회귀/NNG,228,156,384,1.3247104265973317,Hawkish
위도/NNG,13,4,17,2.9457376591440667,Hawkish
매수주체/NNG,84,55,139,1.384290704157212,Hawkish
실용/NNG,11,6,17,1.661698166696653,Hawkish
통신요금/NNG,34,22,56,1.4007703553971786,Hawkish
구성종목/NNG,141,74,215,1.7270229103505754,Hawkish
전망/NNG;상회/NNG,73,31,104,2.1343806364021525,Hawkish
수정안/NNG,16,11,27,1.3183720991973447,Hawkish
변하/VV,488,316,804,1.3997273394959149,Hawkish
재정비/NNG,67,15,82,4.048500987951846,Hawkish
이루어진다/VV,20,9,29,2.0141795959959437,Hawkish
물가/NNG;압력/NNG;완화/NNG,26,10,36,2.3565901273152536,Hawkish
금리선물/NNG;시장/NNG;금리/NNG;인하/NNG,12,7,19,1.5537956883397277,Hawkish
개발비/NNG,12,7,19,1.5537956883397277,Hawkish
부동산/NNG;불안/NNG,21,10,31,1.9033997182161664,Hawkish
원동력/NNG,37,25,62,1.3414436109332981,Hawkish
고용/NNG;위축/NNG,14,5,19,2.5378662909548884,Hawkish
확확/MAG,158,103,261,1.3903705754884617,Hawkish
저축/NNG;증가/NNG,11,7,18,1.424312714311417,Hawkish
힘겹/VA,13,6,19,1.9638251060960445,Hawkish
감사인/NNG,21,7,28,2.7191424545945235,Hawkish
운송비/NNG,20,4,24,4.5319040909908725,Hawkish
비보장/NNG,13,4,17,2.9457376591440667,Hawkish
인건비/NNG;부담/NNG,13,7,20,1.6832786623680382,Hawkish
들여/VV,19,8,27,2.1526544432206642,Hawkish
선사/NNG,53,34,87,1.4128877460148013,Hawkish
금리/NNG;인상/NNG;축소/NNG,15,6,21,2.265952045495436,Hawkish
신규주/NNG,13,5,18,2.3565901273152536,Hawkish
엑시트/NNG,17,2,19,7.704236954684482,Hawkish
뉴딜/NNG,113,72,185,1.422514339672135,Hawkish
재재재재/MAG,310,214,524,1.3129815590721219,Hawkish
환물/NNG,16,2,18,7.251046545585395,Hawkish
사격/NNG,23,10,33,2.084675881855801,Hawkish
희소식/NNG,16,8,24,1.8127616363963488,Hawkish
제조업/NNG;지표/NNG;둔화/NNG,16,3,19,4.834031030390264,Hawkish
이연/NNG,160,93,253,1.5593648485129885,Hawkish
분화/NNG,13,4,17,2.9457376591440667,Hawkish
진균/NNG,175,66,241,2.4032824724951594,Hawkish
잠재/NNG;성장률/NNG;낮/VA,12,5,17,2.1753139636756185,Hawkish
바깥/NNG,18,9,27,1.812761636396349,Hawkish
공고/NNG,144,99,243,1.3183720991973447,Hawkish
첫발/NNG,27,9,36,2.7191424545945235,Hawkish
감소액/NNG,12,5,17,2.1753139636756185,Hawkish
금융스트레스/NNG,31,14,45,2.0069860974388147,Hawkish
예상/NNG;소폭/MAG;밑돌/VV,12,7,19,1.5537956883397277,Hawkish
소비자/NNG;물가/NNG;상승률/NNG;점차/MAG;낮/VA,16,6,22,2.417015515195132,Hawkish
가격/NNG;상승/NNG;확대/NNG,53,20,73,2.401909168225162,Hawkish
승승/NNG,601,212,813,2.569504111967466,Hawkish
높/VA;위험/NNG;회피/NNG,11,7,18,1.424312714311417,Hawkish
금리/NNG;인상/NNG;높/VA,18,5,23,3.262970945513428,Hawkish
산업/NNG;안정/NNG,14,3,17,4.229777151591481,Hawkish
좁혀져/VV,12,6,18,1.8127616363963488,Hawkish
환경/NNG;긴축/NNG,33,18,51,1.6616981666966535,Hawkish
비주류/NNG,56,14,70,3.625523272792698,Hawkish
roa/NNG,239,103,342,2.103155490770521,Hawkish
농산물/NNG,532,299,831,1.612690954118491,Hawkish
울상/NNG,11,6,17,1.661698166696653,Hawkish
부정적/VAX;안정/NNG;하향/NNG,18,10,28,1.631485472756714,Hawkish
금전/NNG,327,213,540,1.391486044839451,Hawkish
인터내셔널/NNG,196,104,300,1.7081792342965594,Hawkish
성장성/NNG;둔화/NNG,12,8,20,1.3595712272972615,Hawkish
불이행/NNG,35,15,50,2.1148885757957405,Hawkish
앞질렀/VV,14,6,20,2.1148885757957405,Hawkish
지속가능경영/NNG,33,20,53,1.495528350026988,Hawkish
인상/NNG;아니/VCN,23,7,30,2.978108402651145,Hawkish
경쟁입찰/NNG,102,57,159,1.6219446220388383,Hawkish
발행/NNG;부담/NNG;완화/NNG,11,6,17,1.661698166696653,Hawkish
예비/NNG,383,202,585,1.7185339275737663,Hawkish
관계개선/NNG,13,6,19,1.9638251060960445,Hawkish
전망/NNG;경기/NNG;둔화/NNG,19,9,28,1.9134706161961461,Hawkish
유동성/NNG;줄/VV,16,8,24,1.8127616363963488,Hawkish
만선/NNG,153,69,222,2.0098009447002996,Hawkish
고유가/NNG,118,65,183,1.645429793036686,Hawkish
유지비/NNG,18,3,21,5.438284909189047,Hawkish
달한다고/VV,14,9,23,1.4099257171971604,Hawkish
사용량/NNG,20,11,31,1.647965123996681,Hawkish
장소/NNG,32,20,52,1.4502093091170791,Hawkish
大金/NNG,75,48,123,1.4162200284346476,Hawkish
물가/NNG;억제/NNG,11,7,18,1.424312714311417,Hawkish
기대/VV,42,20,62,1.9033997182161664,Hawkish
원료/NNG,40,24,64,1.5106346969969575,Hawkish
광역시/NNG,166,17,183,8.850542107111586,Hawkish
행복/NNG,52,36,88,1.309216737397363,Hawkish
장장/MAG,1151,801,1952,1.3024273679726577,Hawkish
이행시/NNG,15,7,22,1.9422446104246596,Hawkish
일반회계/NNG,38,7,45,4.920353013075804,Hawkish
중형주/NNG,33,14,47,2.136469071467126,Hawkish
필라델피아반도체지수/NNG;상승/NNG,15,5,20,2.719142454594523,Hawkish
토의/NNG,15,8,23,1.699464034121577,Hawkish
금리정상화/NNG,164,100,264,1.486464541845006,Hawkish
의욕/NNG,14,5,19,2.5378662909548884,Hawkish
전강후약/NNG,59,41,100,1.3043041042363974,Hawkish
fed/NNG;만장일치/NNG;금리/NNG;인상/NNG,11,6,17,1.661698166696653,Hawkish
세밀/NNG,22,11,33,1.8127616363963488,Hawkish
중국a주/NNG,16,5,21,2.9004186182341583,Hawkish
장성/NNG,22,13,35,1.5338752307969103,Hawkish
액면분할/NNG,24,9,33,2.417015515195132,Hawkish
채신/NNG,22,12,34,1.661698166696653,Hawkish
공여/NNG,38,14,52,2.460176506537902,Hawkish
제조업/NNG;pmi/NNG;호조/NNG,15,6,21,2.265952045495436,Hawkish
높/VA;fed/NNG;금리/NNG;인하/NNG,12,5,17,2.1753139636756185,Hawkish
광장/NNG,19,13,32,1.3247104265973317,Hawkish
전투/NNG,18,11,29,1.4831686115970129,Hawkish
평행/NNG,12,5,17,2.1753139636756185,Hawkish
시급/NNG,191,102,293,1.6972425125083461,Hawkish
모디/NNG,67,15,82,4.048500987951846,Hawkish
관광객/NNG,86,58,144,1.3439439718110862,Hawkish
따따따/MAG,51,32,83,1.4445444290033405,Hawkish
기고문/NNG,13,4,17,2.9457376591440667,Hawkish
건전재정/NNG,42,26,68,1.464153629397051,Hawkish
경제/NNG;경기/NNG;침체/NNG,19,12,31,1.4351029621471094,Hawkish
중력/NNG,26,7,33,3.3665573247360765,Hawkish
아파트매매가격지수/NNG,32,12,44,2.417015515195132,Hawkish
인상/NNG;중단/NNG,19,7,26,2.460176506537902,Hawkish
금리/NNG;인하/NNG;가능성/NNG;배제/NNG,32,16,48,1.8127616363963488,Hawkish
채권시장/NNG;소폭/MAG;약세/NNG,12,8,20,1.3595712272972615,Hawkish
상승률/NNG;소폭/MAG;둔화/NNG,14,5,19,2.5378662909548884,Hawkish
대륙/NNG,11,7,18,1.424312714311417,Hawkish
신호탄/NNG,33,19,52,1.574240368449461,Hawkish
업장/NNG,12,8,20,1.3595712272972615,Hawkish
전망/NNG;소폭/MAG;하회/NNG,49,15,64,2.9608440061140366,Hawkish
벌써/MAG,59,31,90,1.725047363667493,Hawkish
운영사/NNG,12,5,17,2.1753139636756185,Hawkish
총괄/NNG,323,202,525,1.4493119023663876,Hawkish
생태계/NNG,108,59,167,1.659137768905133,Hawkish
금리/NNG;인하/NNG;쉽/VA;않/VX,34,10,44,3.081694781873793,Hawkish
효자/NNG,14,8,22,1.5861664318468052,Hawkish
미칠지/VV,53,34,87,1.4128877460148013,Hawkish
교통비/NNG,18,12,30,1.3595712272972618,Hawkish
반반/NNG,256,140,396,1.6573820675623763,Hawkish
어울리/VV,12,7,19,1.5537956883397277,Hawkish
구매력/NNG;감소/NNG,14,8,22,1.5861664318468052,Hawkish
솔직히/MAG,22,14,36,1.424312714311417,Hawkish
비용/NNG;상승/NNG,84,56,140,1.3595712272972618,Hawkish
최장/NNG,100,39,139,2.324053379995319,Hawkish
중후/NNG,59,20,79,2.6738234136846146,Hawkish
부채한도/NNG,778,389,1167,1.8127616363963488,Hawkish
금융위기/NNG;최대/NNG,12,6,18,1.8127616363963488,Hawkish
순이익/NNG,964,620,1584,1.4092759818436131,Hawkish
가격/NNG;절하/NNG,11,7,18,1.424312714311417,Hawkish
예상/NNG;소폭/MAG;하회/NNG,30,19,49,1.431127607681328,Hawkish
둔화/NNG;지지/NNG,15,5,20,2.719142454594523,Hawkish
미뤘/VV,27,9,36,2.7191424545945235,Hawkish
실업률/NNG;최저/NNG,17,9,26,1.7120526565965517,Hawkish
대식/NNG,18,7,25,2.3306935325095917,Hawkish
기장/NNG,21,10,31,1.9033997182161664,Hawkish
기름/NNG,36,16,52,2.0393568409458926,Hawkish
미/NNG;금리/NNG;하락/NNG,55,27,82,1.8463312963296146,Hawkish
엇갈림/NNG,19,13,32,1.3247104265973317,Hawkish
구조물/NNG,14,5,19,2.5378662909548884,Hawkish
경제/NNG;모멘텀/NNG,13,6,19,1.9638251060960445,Hawkish
완화/NNG;성장/NNG,15,8,23,1.699464034121577,Hawkish
주황색/NNG,14,9,23,1.4099257171971604,Hawkish
탄소/NNG,444,246,690,1.6359068426015833,Hawkish
지만/NNG,11,7,18,1.424312714311417,Hawkish
물가/NNG;통제/NNG,17,5,22,3.081694781873793,Hawkish
상관관계/NNG,427,258,685,1.500095385157444,Hawkish
수그러들/VV,25,12,37,1.8882933712461967,Hawkish
견도/NNG,14,9,23,1.4099257171971604,Hawkish
경기/NNG;불안/NNG,24,12,36,1.8127616363963488,Hawkish
채권평가사/NNG,11,6,17,1.661698166696653,Hawkish
최대/NNG;상승/NNG,48,21,69,2.07172758445297,Hawkish
적응/NNG,155,105,260,1.3379907316258766,Hawkish
실업률/NNG;급등/NNG,16,4,20,3.6255232727926976,Hawkish
자동/NNG,157,102,259,1.3951155731089548,Hawkish
탕감/NNG,51,25,76,1.8490168691242757,Hawkish
인적자본/NNG,19,9,28,1.9134706161961461,Hawkish
반부/NNG,11,7,18,1.424312714311417,Hawkish
의사소통/NNG,36,17,53,1.9193946738314283,Hawkish
유독/MAG,40,27,67,1.3427863973306289,Hawkish
발행/NNG;부담/NNG,34,19,53,1.6219446220388385,Hawkish
사칭/NNG,92,39,131,2.1381291095956936,Hawkish
집값/NNG;하락/NNG,12,7,19,1.5537956883397277,Hawkish
미/NNG;금리/NNG;급등/NNG,36,21,57,1.5537956883397277,Hawkish
높/VA;상승/NNG,39,23,62,1.5369066047708175,Hawkish
예금자/NNG,78,44,122,1.606765995896764,Hawkish
동광/NNG,15,6,21,2.265952045495436,Hawkish
대내외/NNG;경기/NNG;불확실성/NNG,43,16,59,2.4358984489075937,Hawkish
마당/NNG,15,9,24,1.5106346969969573,Hawkish
수출/NNG;좋/VA,13,9,22,1.309216737397363,Hawkish
지기/NNG,13,6,19,1.9638251060960445,Hawkish
치본/NNG,47,1,48,42.599898455314204,Hawkish
판매업/NNG,30,5,35,5.438284909189046,Hawkish
다가구/NNG,26,9,35,2.618433474794726,Hawkish
파급효과/NNG,448,297,745,1.367200695463913,Hawkish
전문의/NNG,16,6,22,2.417015515195132,Hawkish
눈높이/NNG,213,129,342,1.4965822812109393,Hawkish
통화/NNG;안정/NNG,18,12,30,1.3595712272972618,Hawkish
유통기업/NNG,20,8,28,2.2659520454954363,Hawkish
상표/NNG,17,8,25,1.9260592386711206,Hawkish
석석/MAG,96,56,152,1.5537956883397277,Hawkish
지지표/NNG,13,9,22,1.309216737397363,Hawkish
골드/NNG,36,14,50,2.3306935325095917,Hawkish
역내외/NNG,21,13,34,1.464153629397051,Hawkish
수익금/NNG,27,16,43,1.5295176307094194,Hawkish
기시/NNG,29,8,37,3.2856304659683824,Hawkish
헤징/NNG,25,9,34,2.5177244949949293,Hawkish
임금/NNG;하락/NNG,23,15,38,1.389783921237201,Hawkish
질의응답/NNG,37,16,53,2.096005642083278,Hawkish
인하/NNG;쉽/VA;않/VX,14,5,19,2.5378662909548884,Hawkish
하락/NNG;부담/NNG,17,10,27,1.5408473909368965,Hawkish
잠깐/MAG,37,25,62,1.3414436109332981,Hawkish
삭삭삭삭/MAG,11,6,17,1.661698166696653,Hawkish
전기요금/NNG,190,103,293,1.6719646160937198,Hawkish
정위/NNG,12,5,17,2.1753139636756185,Hawkish
취임사/NNG,15,3,18,4.531904090990872,Hawkish
브렌트유/NNG,339,161,500,1.9084664432868395,Hawkish
화오/NNG,25,12,37,1.8882933712461967,Hawkish
가구수/NNG,27,6,33,4.078713681891785,Hawkish
경기/NNG;침체/NNG;우려/NNG;완화/NNG,22,12,34,1.661698166696653,Hawkish
주택담보대출/NNG;증가/NNG,26,18,44,1.309216737397363,Hawkish
공정거래위원회/NNG,19,10,29,1.7221235545765314,Hawkish
채권투자/NNG;확대/NNG,11,6,17,1.661698166696653,Hawkish
잔금/NNG,19,4,23,4.3053088864413285,Hawkish
목차/NNG,12,7,19,1.5537956883397277,Hawkish
영세/NNG,31,21,52,1.3379907316258763,Hawkish
깨닫/VV,16,10,26,1.4502093091170791,Hawkish
금리/NNG;인하/NNG;기대/NNG;살/VV,54,23,77,2.1280245296826705,Hawkish
블랙홀/NNG,11,6,17,1.661698166696653,Hawkish
소비/NNG;지표/NNG;개선/NNG,12,8,20,1.3595712272972615,Hawkish
리적/NNG,16,11,27,1.3183720991973447,Hawkish
금리/NNG;인상/NNG;어렵/VA,41,21,62,1.7696006450535784,Hawkish
장기물/NNG;금리/NNG;상승/NNG,48,31,79,1.4034283636616893,Hawkish
금융안정보고서/NNG,70,46,116,1.3792751581276568,Hawkish
성장/NNG;견조/NNG,14,7,21,1.812761636396349,Hawkish
은은/NNG,659,306,965,1.9519769908254805,Hawkish
공급/NNG;증가/NNG,44,29,73,1.375198482783437,Hawkish
템플/NNG,23,8,31,2.6058448523197515,Hawkish
고용자수/NNG;증가/NNG;축소/NNG,25,14,39,1.618537175353883,Hawkish
유동성지수/NNG,12,6,18,1.8127616363963488,Hawkish
수요/NNG;제한/NNG,15,5,20,2.719142454594523,Hawkish
당당/MAG,282,167,449,1.5305352738436238,Hawkish
마이너스/NNG;축소/NNG,16,7,23,2.0717275844529706,Hawkish
약하/VA;금리/NNG;인하/NNG,44,15,59,2.658717066714645,Hawkish
금리/NNG;긴축/NNG,54,34,88,1.4395460053735711,Hawkish
우크라이나사태/NNG,220,86,306,2.318648604693004,Hawkish
기울었/VV,36,24,60,1.3595712272972618,Hawkish
단기물/NNG;상승/NNG,11,7,18,1.424312714311417,Hawkish
예방주사/NNG,12,5,17,2.1753139636756185,Hawkish
공수/NNG,38,23,61,1.4974987431100273,Hawkish
돈줄/NNG,19,13,32,1.3247104265973317,Hawkish
스틱/NNG,19,4,23,4.3053088864413285,Hawkish
구인/NNG,468,303,771,1.3999545310783683,Hawkish
결정문/NNG,221,107,328,1.8720575777737996,Hawkish
요주/NNG,176,62,238,2.5729520000464303,Hawkish
높/VA;금리/NNG;오르/VV,14,8,22,1.5861664318468052,Hawkish
fx스왑/NNG,56,38,94,1.3357191005025728,Hawkish
락세/NNG,18,8,26,2.0393568409458926,Hawkish
기울였/VV,13,9,22,1.309216737397363,Hawkish
우회/NNG,51,25,76,1.8490168691242757,Hawkish
경기/NNG;둔화/NNG;금리/NNG;상승/NNG,32,10,42,2.9004186182341583,Hawkish
쓰레기/NNG,13,9,22,1.309216737397363,Hawkish
출도/NNG,28,18,46,1.4099257171971604,Hawkish
세가/NNG,22,10,32,1.9940378000359835,Hawkish
기본공제/NNG,17,2,19,7.704236954684482,Hawkish
폭폭폭폭/MAG,120,30,150,3.6255232727926976,Hawkish
국고채/NNG;스프레드/NNG;축소/NNG,71,45,116,1.4300675131571194,Hawkish
스타트/NNG,13,7,20,1.6832786623680382,Hawkish
곧이어/MAG,12,5,17,2.1753139636756185,Hawkish
월물간/NNG,22,9,31,2.2155975555955374,Hawkish
정책조합/NNG,37,13,50,2.579699251794804,Hawkish
점증/NNG,105,72,177,1.3218053598723378,Hawkish
다다랐/VV,19,12,31,1.4351029621471094,Hawkish
동률/NNG,14,7,21,1.812761636396349,Hawkish
경기/NNG;성장/NNG,27,9,36,2.7191424545945235,Hawkish
유로존/NNG;물가/NNG;상승/NNG;압력/NNG,12,5,17,2.1753139636756185,Hawkish
춘계/NNG,49,30,79,1.4804220030570183,Hawkish
무역/NNG;적자/NNG,46,30,76,1.389783921237201,Hawkish
비유동부채/NNG,12,7,19,1.5537956883397277,Hawkish
무력/NNG,71,37,108,1.7392712997856858,Hawkish
지표/NNG;긍정적/VAX,28,12,40,2.1148885757957405,Hawkish
잇단/VV,42,20,62,1.9033997182161664,Hawkish
투자/NNG;매력/NNG;높/VV,11,7,18,1.424312714311417,Hawkish
공산당/NNG,29,18,47,1.460280207097059,Hawkish
가르/VV,25,13,38,1.7430400349964892,Hawkish
가격/NNG;내리/VV,26,17,43,1.3862294866560314,Hawkish
상향/NNG;하향/NNG,24,13,37,1.6733184335966296,Hawkish
승률/NNG,112,41,153,2.4759671131267207,Hawkish
고급/NNG,28,14,42,1.812761636396349,Hawkish
수수/MAG,92,55,147,1.5161279140769464,Hawkish
은도/NNG,27,14,41,1.7480201493821939,Hawkish
안다/VV,14,9,23,1.4099257171971604,Hawkish
학년도/NNG,14,8,22,1.5861664318468052,Hawkish
탈라/NNG,17,6,23,2.5680789848948273,Hawkish
장난감/NNG,13,7,20,1.6832786623680382,Hawkish
스카/NNG,38,8,46,4.3053088864413285,Hawkish
토지신탁/NNG,14,8,22,1.5861664318468052,Hawkish
저저/MAG,64,44,108,1.3183720991973447,Hawkish
유통량/NNG,15,7,22,1.9422446104246596,Hawkish
충당부채/NNG,40,27,67,1.3427863973306289,Hawkish
진보당/NNG,14,5,19,2.5378662909548884,Hawkish
신용위기/NNG,87,38,125,2.0751350311379255,Hawkish
봉사/NNG,22,11,33,1.8127616363963488,Hawkish
채권시장/NNG;금리/NNG;인상/NNG,28,19,47,1.3357191005025728,Hawkish
바젤iii/NNG,46,29,75,1.4377075047281387,Hawkish
외국통/NNG,11,7,18,1.424312714311417,Hawkish
생보사/NNG,241,149,390,1.4660253502400002,Hawkish
부국/NNG,34,12,46,2.5680789848948273,Hawkish
타임/NNG,31,20,51,1.4048902682071702,Hawkish
담보대출/NNG,221,130,351,1.5408473909368967,Hawkish
금리/NNG;상승/NNG;모멘텀/NNG,12,7,19,1.5537956883397277,Hawkish
불안/NNG;확산/NNG,43,22,65,1.771562508296432,Hawkish
폭주/NNG,17,11,28,1.4007703553971786,Hawkish
회사채/NNG;수요예측/NNG;흥행/NNG,31,21,52,1.3379907316258763,Hawkish
노코멘트/NNG,22,10,32,1.9940378000359835,Hawkish
고압경제/NNG,39,25,64,1.413954076389152,Hawkish
어업/NNG,36,25,61,1.3051883782053713,Hawkish
중기부/NNG,19,10,29,1.7221235545765314,Hawkish
역효과/NNG,19,8,27,2.1526544432206642,Hawkish
장초/NNG,302,153,455,1.7890654058552202,Hawkish
채권/NNG;선호/NNG,19,11,30,1.5655668677968468,Hawkish
매입오퍼레이션/NNG,16,10,26,1.4502093091170791,Hawkish
캐피탈콜/NNG,18,3,21,5.438284909189047,Hawkish
공급업체/NNG,20,13,33,1.3944320279971913,Hawkish
국고채/NNG;수익률/NNG;하락/NNG,19,13,32,1.3247104265973317,Hawkish
분절/NNG,52,15,67,3.1421201697536714,Hawkish
신용/NNG;긴축/NNG,16,7,23,2.0717275844529706,Hawkish
기울기/NNG,94,62,156,1.374190272752071,Hawkish
물가/NNG;예상/NNG;높/VA,17,8,25,1.9260592386711206,Hawkish
대출/NNG;수요/NNG;증가/NNG,24,12,36,1.8127616363963488,Hawkish
성장/NNG;꺾/VV,11,6,17,1.661698166696653,Hawkish
투자활동현금흐름/NNG,15,7,22,1.9422446104246596,Hawkish
고전/NNG,42,25,67,1.522719774572933,Hawkish
방역/NNG,183,93,276,1.7835235454867304,Hawkish
선회/NNG,161,99,260,1.4740132497970313,Hawkish
사차/NNG,29,7,36,3.755006246821009,Hawkish
비거주자/NNG,30,12,42,2.265952045495436,Hawkish
특정금전신탁/NNG,23,16,39,1.3029224261598757,Hawkish
잉여금/NNG,155,55,210,2.5543459421948556,Hawkish
거짓말/NNG,25,1,26,22.65952045495436,Hawkish
들썩이/VV,21,11,32,1.7303633801965148,Hawkish
누그러진/VV,36,16,52,2.0393568409458926,Hawkish
게시물/NNG,25,5,30,4.5319040909908725,Hawkish
유발/NNG,423,256,679,1.4976526800696397,Hawkish
드러낼/VV,18,10,28,1.631485472756714,Hawkish
경기/NNG;금융안정/NNG,24,15,39,1.4502093091170791,Hawkish
이종통화/NNG,26,10,36,2.3565901273152536,Hawkish
포격/NNG,14,3,17,4.229777151591481,Hawkish
물가/NNG;경로/NNG;불확실성/NNG,30,15,45,1.8127616363963488,Hawkish
리비전/NNG,19,8,27,2.1526544432206642,Hawkish
대손/NNG,50,28,78,1.618537175353883,Hawkish
프록시/NNG,27,3,30,8.15742736378357,Hawkish
겨우/MAG,46,24,70,1.737229901546501,Hawkish
ecb/NNG;금리/NNG;인상/NNG,59,29,88,1.8440161473686996,Hawkish
트위터/NNG,192,76,268,2.289804172290125,Hawkish
탄소세/NNG,33,18,51,1.6616981666966535,Hawkish
소비자/NNG;물가/NNG;농산물/NNG;가격/NNG;상승/NNG,15,8,23,1.699464034121577,Hawkish
사무처장/NNG,15,7,22,1.9422446104246596,Hawkish
세입/NNG,210,107,317,1.77887824132352,Hawkish
매파/NNG,2757,1738,4495,1.437797419892041,Hawkish
약발/NNG,23,14,37,1.4890542013255725,Hawkish
fed/NNG;금리/NNG;인하/NNG;늦/VV,38,22,60,1.5655668677968468,Hawkish
지정학/NNG;위험/NNG;크/VV,17,7,24,2.201210558481281,Hawkish
예산정책처/NNG,44,11,55,3.6255232727926976,Hawkish
작작/MAG,207,75,282,2.5016110582269615,Hawkish
비디아/NNG,23,9,32,2.3163065353953347,Hawkish
무가/NNG,14,8,22,1.5861664318468052,Hawkish
장기물/NNG;순매수/NNG;강화/NNG,30,16,46,1.699464034121577,Hawkish
신용위험평가/NNG,37,16,53,2.096005642083278,Hawkish
상승효과/NNG,25,15,40,1.5106346969969575,Hawkish
수입/NNG;물가/NNG;급등/NNG,13,4,17,2.9457376591440667,Hawkish
건들/VV,20,11,31,1.647965123996681,Hawkish
소비자금융/NNG,35,22,57,1.4419694834970957,Hawkish
무역/NNG;개선/NNG,14,9,23,1.4099257171971604,Hawkish
증자/NNG,75,46,121,1.4777948122796323,Hawkish
금리/NNG;인하/NNG;기대/NNG;꺾/VV,21,6,27,3.1723328636936103,Hawkish
대결/NNG,68,45,113,1.3696421252772413,Hawkish
전망대/NNG,23,12,35,1.737229901546501,Hawkish
예상/NNG;축소/NNG,11,6,17,1.661698166696653,Hawkish
gdp/NNG;갭/NNG;플러스/NNG,19,9,28,1.9134706161961461,Hawkish
비주/NNG,36,5,41,6.525941891026856,Hawkish
물가/NNG;안정/NNG;회복/NNG,20,9,29,2.0141795959959437,Hawkish
나스/VV,97,50,147,1.7583787873044585,Hawkish
보건/NNG,141,84,225,1.5214249448326498,Hawkish
국채/NNG;금리/NNG;인상/NNG,13,6,19,1.9638251060960445,Hawkish
상하방/NNG;위험/NNG,14,9,23,1.4099257171971604,Hawkish
경기/NNG;긍정적/VAX,29,19,48,1.3834233540919505,Hawkish
경기/NNG;완만/NNG;회복/NNG,14,9,23,1.4099257171971604,Hawkish
불법/NNG,391,249,640,1.4232726904236392,Hawkish
기승/NNG,13,6,19,1.9638251060960445,Hawkish
국채/NNG;금리/NNG;상승/NNG;압력/NNG,16,9,25,1.6113436767967546,Hawkish
무담보채/NNG,17,7,24,2.201210558481281,Hawkish
부진/NNG;완화/NNG,18,5,23,3.262970945513428,Hawkish
만기보유전략/NNG,15,5,20,2.719142454594523,Hawkish
라라/NNG,120,49,169,2.2197081261996106,Hawkish
절하/NNG;압력/NNG,19,8,27,2.1526544432206642,Hawkish
예상/NNG;견고/NNG,14,9,23,1.4099257171971604,Hawkish
충분히/MAG;완화/NNG,11,7,18,1.424312714311417,Hawkish
개개인/NNG,20,13,33,1.3944320279971913,Hawkish
유심히/MAG,31,19,50,1.4788318612707056,Hawkish
오락/NNG,73,44,117,1.5037681756469712,Hawkish
예상/NNG;덜/MAG;매파/NNG,19,2,21,8.610617772882657,Hawkish
입지/NNG,135,79,214,1.548878613376627,Hawkish
금융안정/NNG;성장/NNG,23,9,32,2.3163065353953347,Hawkish
사료/NNG,35,20,55,1.5861664318468052,Hawkish
지원자금/NNG,25,13,38,1.7430400349964892,Hawkish
디폴트옵션/NNG,17,1,18,15.408473909368965,Hawkish
유가/NNG;부담/NNG,13,4,17,2.9457376591440667,Hawkish
달러엔/NNG;환율/NNG;오르/VV,25,17,42,1.332912967938492,Hawkish
축강/NNG,14,8,22,1.5861664318468052,Hawkish
개선/NNG;둔화/NNG,16,10,26,1.4502093091170791,Hawkish
dps/NNG,55,17,72,2.9324085294646816,Hawkish
결심/NNG,13,5,18,2.3565901273152536,Hawkish
금리/NNG;하락/NNG;되돌/VV,36,18,54,1.812761636396349,Hawkish
하락주/NNG,41,13,54,2.8585856573942423,Hawkish
국토연구원/NNG,21,11,32,1.7303633801965148,Hawkish
예상/NNG;둔화/NNG,60,39,99,1.3944320279971911,Hawkish
채소/NNG,41,25,66,1.486464541845006,Hawkish
공원/NNG,68,32,100,1.9260592386711206,Hawkish
지원주체/NNG,20,10,30,1.812761636396349,Hawkish
하오/NNG,13,5,18,2.3565901273152536,Hawkish
집어넣/VV,13,4,17,2.9457376591440667,Hawkish
중권/NNG,53,1,54,48.03818336450325,Hawkish
예상/NNG;늦/VV,22,10,32,1.9940378000359835,Hawkish
가리키/VV,100,63,163,1.4386997114256737,Hawkish
대외/NNG;여건/NNG;개선/NNG,16,7,23,2.0717275844529706,Hawkish
실리콘밸리/NNG,122,38,160,2.909959468952034,Hawkish
바뀐다/VV,47,5,52,8.51997969106284,Hawkish
꾸꾸꾸/MAG,15,3,18,4.531904090990872,Hawkish
놀랐/VV,18,9,27,1.812761636396349,Hawkish
경고음/NNG,32,18,50,1.6113436767967546,Hawkish
긴축/NNG;선호/NNG,18,2,20,8.15742736378357,Hawkish
갤러리/NNG,43,27,70,1.443495377130426,Hawkish
인플레이션/NNG;쉽/VA,14,4,18,3.1723328636936103,Hawkish
재배/NNG,21,5,26,3.8067994364323328,Hawkish
인제/MAG,19,8,27,2.1526544432206642,Hawkish
전약후강/NNG,65,37,102,1.5922906265643604,Hawkish
매파/NNG;긴축/NNG,20,4,24,4.5319040909908725,Hawkish
공화/NNG,43,27,70,1.443495377130426,Hawkish
유기전/NNG,11,7,18,1.424312714311417,Hawkish
자금력/NNG,30,12,42,2.265952045495436,Hawkish
금리/NNG;인상/NNG;가능성/NNG;낮/VA,49,24,73,1.8505275038212727,Hawkish
발족/NNG,33,13,46,2.300812846195366,Hawkish
경기/NNG;양호/NNG,24,14,38,1.5537956883397277,Hawkish
북핵/NNG,45,22,67,1.853960764496266,Hawkish
불균형/NNG,731,441,1172,1.5024135557888108,Hawkish
하락/NNG;약세/NNG,15,7,22,1.9422446104246596,Hawkish
운전자본/NNG,159,40,199,3.602863752337743,Hawkish
라이/NNG,23,5,28,4.169351763711602,Hawkish
민간/NNG;소비/NNG;회복/NNG,55,18,73,2.769496944494422,Hawkish
법인세/NNG,338,228,566,1.3436698094341357,Hawkish
인플레이션/NNG;높/VA,82,38,120,1.9558743971644816,Hawkish
공급자/NNG,57,28,85,1.8451323799034267,Hawkish
됨됨/NNG,26,13,39,1.8127616363963488,Hawkish
제목/NNG,76,29,105,2.3753428338986637,Hawkish
주택차압/NNG,13,8,21,1.4728688295720334,Hawkish
기대/NNG;차단/NNG,17,9,26,1.7120526565965517,Hawkish
투자/NNG;약화/NNG,11,7,18,1.424312714311417,Hawkish
원했/VV,26,11,37,2.142354661195685,Hawkish
금융서비스/NNG,98,65,163,1.3665433874372477,Hawkish
부동산/NNG;부실/NNG,13,6,19,1.9638251060960445,Hawkish
대내외/NNG;불확실성/NNG,47,30,77,1.4199966151771402,Hawkish
하락/NNG;상승/NNG;하락/NNG,17,3,20,5.136157969789655,Hawkish
재무장관회의/NNG,122,73,195,1.5147734221942093,Hawkish
고물가/NNG,398,211,609,1.709666187880917,Hawkish
낮/VA;증가/NNG,20,13,33,1.3944320279971913,Hawkish
오피/NNG,14,7,21,1.812761636396349,Hawkish
나쁘/VA;지지/NNG;않/VX,12,7,19,1.5537956883397277,Hawkish
공사비/NNG,152,72,224,1.9134706161961461,Hawkish
채전/NNG,14,9,23,1.4099257171971604,Hawkish
불황/NNG,217,124,341,1.5861664318468052,Hawkish
예술/NNG,33,17,50,1.7594451176788093,Hawkish
참모/NNG,11,6,17,1.661698166696653,Hawkish
금리옵션/NNG,16,5,21,2.9004186182341583,Hawkish
방심/NNG,18,9,27,1.812761636396349,Hawkish
헐값/NNG,21,6,27,3.1723328636936103,Hawkish
부품/NNG,558,345,903,1.465972453781395,Hawkish
미시/NNG,200,139,339,1.3041450621556467,Hawkish
요하/VV,18,12,30,1.3595712272972618,Hawkish
유동성/NNG;감소/NNG,21,12,33,1.5861664318468052,Hawkish
상저하고/NNG,65,40,105,1.4728688295720334,Hawkish
전망/NNG;어둡/VA,16,9,25,1.6113436767967546,Hawkish
업사/NNG,17,5,22,3.081694781873793,Hawkish
어린이집/NNG,14,8,22,1.5861664318468052,Hawkish
저축/NNG,685,436,1121,1.4240157350131868,Hawkish
국가채무비율/NNG,34,20,54,1.5408473909368965,Hawkish
바이백/NNG,296,96,392,2.794674189444371,Hawkish
중국시장/NNG,49,34,83,1.3062547085797218,Hawkish
대대로/NNG,12,5,17,2.1753139636756185,Hawkish
경제/NNG;글로벌/NNG;경기/NNG;둔화/NNG,33,10,43,2.991056700053976,Hawkish
상방/NNG;위험/NNG,43,26,69,1.4990144300969808,Hawkish
거점/NNG,50,30,80,1.5106346969969575,Hawkish
매매차익/NNG,23,14,37,1.4890542013255725,Hawkish
측정/NNG,245,147,392,1.5106346969969573,Hawkish
박빙/NNG,19,13,32,1.3247104265973317,Hawkish
월대/NNG,16,11,27,1.3183720991973447,Hawkish
단지/NNG,85,46,131,1.674834120583583,Hawkish
승수효과/NNG,11,6,17,1.661698166696653,Hawkish
계실/VV,31,19,50,1.4788318612707056,Hawkish
엔드/NNG,13,8,21,1.4728688295720334,Hawkish
임계점/NNG,24,13,37,1.6733184335966296,Hawkish
소문난/VV,25,4,29,5.66488011373859,Hawkish
주택시장/NNG;침체/NNG,14,7,21,1.812761636396349,Hawkish
향조/NNG,26,14,40,1.6832786623680382,Hawkish
건설자금/NNG,11,6,17,1.661698166696653,Hawkish
내림차순/NNG,21,1,22,19.033997182161663,Hawkish
버즈/NNG,11,7,18,1.424312714311417,Hawkish
글로벌/NNG;국채/NNG;금리/NNG;하락/NNG,23,13,36,1.6035968321967702,Hawkish
진흥원/NNG,12,8,20,1.3595712272972615,Hawkish
쌍둥이적자/NNG,28,16,44,1.5861664318468052,Hawkish
fed/NNG;자산/NNG;축소/NNG,45,24,69,1.699464034121577,Hawkish
타격/NNG;없/VA,11,7,18,1.424312714311417,Hawkish
경제/NNG;전망/NNG;위험/NNG,17,7,24,2.201210558481281,Hawkish
식당/NNG,26,16,42,1.4728688295720334,Hawkish
어둡/VA,45,31,76,1.3157140909328338,Hawkish
재고자산/NNG,49,17,66,2.6125094171594436,Hawkish
종말/NNG,15,8,23,1.699464034121577,Hawkish
인플레이션/NNG;상방/NNG,34,16,50,1.9260592386711206,Hawkish
기대조정/NNG,16,10,26,1.4502093091170791,Hawkish
프라이빗에쿼티/NNG,14,9,23,1.4099257171971604,Hawkish
던지/VV,50,28,78,1.618537175353883,Hawkish
예단/NNG,157,102,259,1.3951155731089548,Hawkish
거래세/NNG,69,28,97,2.233581301988359,Hawkish
전재/NNG,130,63,193,1.8703096248533757,Hawkish
서구/NNG,35,16,51,1.9827080398085066,Hawkish
금융소득종합과세/NNG,16,3,19,4.834031030390264,Hawkish
여의치/VA,45,29,74,1.406452993755788,Hawkish
자산관리자/NNG,15,7,22,1.9422446104246596,Hawkish
펀더멘털/NNG;불안/NNG,13,7,20,1.6832786623680382,Hawkish
충격파/NNG,21,8,29,2.379249647770208,Hawkish
금리/NNG;하락/NNG;축소/NNG,13,8,21,1.4728688295720334,Hawkish
fed/NNG;금리/NNG;인하/NNG;기대/NNG;크/VV,13,9,22,1.309216737397363,Hawkish
펀더멘털/NNG;저하/NNG,18,11,29,1.4831686115970129,Hawkish
공격/NNG,847,462,1309,1.6616981666966533,Hawkish
투표소/NNG,16,4,20,3.6255232727926976,Hawkish
물가/NNG;압력/NNG;높/VA,15,3,18,4.531904090990872,Hawkish
소비지/NNG,19,8,27,2.1526544432206642,Hawkish
불어넣/VV,30,18,48,1.5106346969969573,Hawkish
든다/VV,85,54,139,1.426710547163793,Hawkish
세세/NNG,635,363,998,1.5855422026331703,Hawkish
정부규제/NNG,20,13,33,1.3944320279971913,Hawkish
실업보험/NNG,188,69,257,2.469559330742852,Hawkish
플러스/NNG;성장/NNG,16,9,25,1.6113436767967546,Hawkish
수자/NNG,13,6,19,1.9638251060960445,Hawkish
감사원/NNG,17,11,28,1.4007703553971786,Hawkish
수요/NNG;물가/NNG;상승/NNG;압력/NNG,17,10,27,1.5408473909368965,Hawkish
우버/NNG,27,16,43,1.5295176307094194,Hawkish
긴축/NNG;가속/NNG,13,6,19,1.9638251060960445,Hawkish
발행시장/NNG;호조/NNG,13,8,21,1.4728688295720334,Hawkish
백스/NNG,24,6,30,3.6255232727926976,Hawkish
충력/NNG,12,7,19,1.5537956883397277,Hawkish
귀추/NNG,17,10,27,1.5408473909368965,Hawkish
침공/NNG,103,55,158,1.6974040777165813,Hawkish
하락/NNG;금리/NNG;인상/NNG,18,8,26,2.0393568409458926,Hawkish
트랜스/NNG,15,5,20,2.719142454594523,Hawkish
분배/NNG,63,38,101,1.5026839880653946,Hawkish
실망/NNG;금리/NNG;인하/NNG,26,1,27,23.565901273152534,Hawkish
두바이유/NNG,34,22,56,1.4007703553971786,Hawkish
상업/NNG,852,567,1419,1.361969060149638,Hawkish
하드/NNG,19,13,32,1.3247104265973317,Hawkish
지표/NNG;충격/NNG,22,8,30,2.4925472500449795,Hawkish
각료/NNG,25,11,36,2.059956404995851,Hawkish
소득대체율/NNG,15,4,19,3.398928068243154,Hawkish
달러인덱스/NNG;강세/NNG,14,6,20,2.1148885757957405,Hawkish
영업현금창출능력/NNG,12,7,19,1.5537956883397277,Hawkish
맹인/NNG,32,1,33,29.00418618234158,Hawkish
경기/NNG;하방/NNG;위험/NNG;증대/NNG,19,3,22,5.740411848588438,Hawkish
인플레이션/NNG,15080,10261,25341,1.3320556221058837,Hawkish
유가/NNG;상승/NNG;제한/NNG,12,7,19,1.5537956883397277,Hawkish
명문/NNG,15,7,22,1.9422446104246596,Hawkish
터널/NNG,51,15,66,3.081694781873793,Hawkish
지식재산권/NNG,16,8,24,1.8127616363963488,Hawkish
싸우/VV,69,13,82,4.81079049659031,Hawkish
시나리오분석/NNG,18,8,26,2.0393568409458926,Hawkish
후반전/NNG,27,4,31,6.1180705228376775,Hawkish
파랑/NNG,12,6,18,1.8127616363963488,Hawkish
행시/NNG,20,9,29,2.0141795959959437,Hawkish
사업자금/NNG,15,6,21,2.265952045495436,Hawkish
환경/NNG;개선/NNG,54,36,90,1.3595712272972618,Hawkish
진국/NNG,50,31,81,1.4619045454809265,Hawkish
재벌/NNG,13,9,22,1.309216737397363,Hawkish
원자재/NNG;가격/NNG;급등/NNG,24,8,32,2.719142454594523,Hawkish
경제/NNG;강하/VA;성장/NNG,14,9,23,1.4099257171971604,Hawkish
공개매수/NNG,32,9,41,3.222687353593509,Hawkish
이익/NNG;늘/VV,13,8,21,1.4728688295720334,Hawkish
최대/NNG;늘/VV,13,6,19,1.9638251060960445,Hawkish
경기/NNG;호조/NNG,67,34,101,1.786103377037579,Hawkish
야권/NNG,45,12,57,3.398928068243154,Hawkish
얼얼/NNG,23,15,38,1.389783921237201,Hawkish
인상/NNG;금리/NNG;인상/NNG,34,11,45,2.8015407107943573,Hawkish
메이커/NNG,26,16,42,1.4728688295720334,Hawkish
외화자산/NNG,50,22,72,2.059956404995851,Hawkish
수입/NNG;물가/NNG;상승/NNG,67,36,103,1.6868754116466025,Hawkish
임대료/NNG,264,161,425,1.4862393540640875,Hawkish
가스/NNG;요금/NNG;인상/NNG,33,13,46,2.300812846195366,Hawkish
유형자산/NNG,26,17,43,1.3862294866560314,Hawkish
노동법/NNG,15,6,21,2.265952045495436,Hawkish
음식/NNG,184,111,295,1.5024691040402172,Hawkish
채권/NNG;금리/NNG;하락/NNG;압력/NNG,12,7,19,1.5537956883397277,Hawkish
금리/NNG;인하/NNG;필요/NNG;없/VA,29,13,42,2.0219264405959274,Hawkish
자산계정/NNG,35,10,45,3.1723328636936103,Hawkish
납입일/NNG,12,5,17,2.1753139636756185,Hawkish
우승/NNG,19,6,25,2.870205924294219,Hawkish
디아/NNG,30,4,34,6.797856136486308,Hawkish
요동치/VV,27,17,44,1.4395460053735711,Hawkish
농업인/NNG,23,10,33,2.084675881855801,Hawkish
물가안정목표제/NNG,44,29,73,1.375198482783437,Hawkish
신정/NNG,15,7,22,1.9422446104246596,Hawkish
인상/NNG;경계/NNG,16,9,25,1.6113436767967546,Hawkish
인플레이션/NNG;회복/NNG,22,12,34,1.661698166696653,Hawkish
다뤘/VV,16,8,24,1.8127616363963488,Hawkish
적자전환/NNG,63,35,98,1.631485472756714,Hawkish
줄줄/MAG,54,19,73,2.5760296938263907,Hawkish
근원/NNG;물가/NNG;상승/NNG,35,21,56,1.5106346969969573,Hawkish
물가/NNG;경계/NNG,54,31,85,1.5788569091194007,Hawkish
매입임대주택/NNG,23,15,38,1.389783921237201,Hawkish
돌돌돌/MAG,18,7,25,2.3306935325095917,Hawkish
학년/NNG,15,6,21,2.265952045495436,Hawkish
집값/NNG;상승/NNG,14,7,21,1.812761636396349,Hawkish
탄소집약도/NNG,23,7,30,2.978108402651145,Hawkish
건설/NNG;투자/NNG;부진/NNG,26,8,34,2.9457376591440667,Hawkish
무효/NNG,25,17,42,1.332912967938492,Hawkish
제각각/NNG,12,5,17,2.1753139636756185,Hawkish
부대/NNG,34,18,52,1.7120526565965517,Hawkish
요새/NNG,14,3,17,4.229777151591481,Hawkish
목도/NNG,11,6,17,1.661698166696653,Hawkish
근원/NNG;물가/NNG;안정/NNG,20,13,33,1.3944320279971913,Hawkish
매파/NNG;금리/NNG;인하/NNG,15,6,21,2.265952045495436,Hawkish
행정/NNG,162,96,258,1.5295176307094194,Hawkish
모험자본/NNG,14,6,20,2.1148885757957405,Hawkish
방사능유출사태/NNG,21,1,22,19.033997182161663,Hawkish
이직률/NNG,47,18,65,2.3666610252952336,Hawkish
둔화/NNG;상승/NNG,23,10,33,2.084675881855801,Hawkish
상방/NNG;위험/NNG;높/VA,14,8,22,1.5861664318468052,Hawkish
임금/NNG;상승/NNG;압력/NNG,47,27,74,1.5777740168634888,Hawkish
내수/NNG;회복/NNG,67,44,111,1.3801707913472203,Hawkish
안전진단/NNG,11,7,18,1.424312714311417,Hawkish
레버리징/NNG,16,5,21,2.9004186182341583,Hawkish
기본소득/NNG,36,7,43,4.661387065019183,Hawkish
기원/NNG,15,8,23,1.699464034121577,Hawkish
이코노믹/NNG,39,26,65,1.3595712272972615,Hawkish
확연히/MAG,56,36,92,1.4099257171971604,Hawkish
유가/NNG;안정/NNG,44,14,58,2.848625428622834,Hawkish
둔화/NNG;성장/NNG,17,3,20,5.136157969789655,Hawkish
저축액/NNG,16,10,26,1.4502093091170791,Hawkish
현수/NNG,175,67,242,2.367412584845978,Hawkish
문장/NNG,30,17,47,1.5994955615261899,Hawkish
인건비/NNG,123,81,204,1.3763560572638946,Hawkish
검단/NNG,32,20,52,1.4502093091170791,Hawkish
외환규제/NNG,52,9,61,5.236866949589452,Hawkish
모처럼/MAG,61,41,102,1.3485178026850888,Hawkish
시가배당률/NNG,17,2,19,7.704236954684482,Hawkish
정리해고/NNG,15,5,20,2.719142454594523,Hawkish
미숙/NNG,15,10,25,1.3595712272972615,Hawkish
빈곤/NNG,35,17,52,1.8660781551138885,Hawkish
총회/NNG,112,46,158,2.206840253004251,Hawkish
채권/NNG;재투자/NNG;중단/NNG,14,4,18,3.1723328636936103,Hawkish
유급/NNG,23,14,37,1.4890542013255725,Hawkish
파마/NNG,12,8,20,1.3595712272972615,Hawkish
공상/NNG,39,10,49,3.5348851909728802,Hawkish
경제/NNG;소비/NNG;회복/NNG,68,8,76,7.704236954684482,Hawkish
유가/NNG;불확실성/NNG,16,6,22,2.417015515195132,Hawkish
디스코/NNG,27,13,40,1.8824832377962084,Hawkish
전부/MAG,52,33,85,1.4282364407971233,Hawkish
아까/MAG,17,5,22,3.081694781873793,Hawkish
고변동성/NNG,62,26,88,2.1613696433956466,Hawkish
물가/NNG;상승/NNG;압력/NNG,109,72,181,1.3721598497722365,Hawkish
매수전략/NNG,809,267,1076,2.7462999322933452,Hawkish
차후/NNG,18,11,29,1.4831686115970129,Hawkish
쌓이/VV,69,24,93,2.6058448523197515,Hawkish
외화표시자산/NNG,86,56,142,1.3919419708043395,Hawkish
해산/NNG,18,9,27,1.812761636396349,Hawkish
경제/NNG;활력/NNG,20,11,31,1.647965123996681,Hawkish
일시적/VAX;둔화/NNG,13,5,18,2.3565901273152536,Hawkish
경정/NNG,19,10,29,1.7221235545765314,Hawkish
비금/NNG,31,20,51,1.4048902682071702,Hawkish
산자/NNG,13,9,22,1.309216737397363,Hawkish
소비/NNG;견조/NNG,14,9,23,1.4099257171971604,Hawkish
강성/NNG,16,6,22,2.417015515195132,Hawkish
높/VA;물가/NNG;상승/NNG,27,12,39,2.0393568409458926,Hawkish
무장단체/NNG,12,7,19,1.5537956883397277,Hawkish
차용/NNG,19,8,27,2.1526544432206642,Hawkish
결코/MAG,87,51,138,1.5461790428086506,Hawkish
재검토/NNG,82,46,128,1.6157223280923978,Hawkish
팬데믹/NNG,1149,794,1943,1.3116266500122196,Hawkish
들렸/VV,16,3,19,4.834031030390264,Hawkish
비용/NNG;높/VA,24,14,38,1.5537956883397277,Hawkish
성장산업/NNG,11,6,17,1.661698166696653,Hawkish
행정처분/NNG,22,10,32,1.9940378000359835,Hawkish
황도/NNG,15,5,20,2.719142454594523,Hawkish
역성장/NNG,273,132,405,1.8745603285462245,Hawkish
역외시장/NNG,14,9,23,1.4099257171971604,Hawkish
변동성/NNG;줄/VV,30,18,48,1.5106346969969573,Hawkish
경제/NNG;취약/NNG,13,4,17,2.9457376591440667,Hawkish
디폴트/NNG,527,351,878,1.3608623680639258,Hawkish
초록색/NNG,27,11,38,2.224752917395519,Hawkish
선행/NNG;지수/NNG;하락/NNG,12,7,19,1.5537956883397277,Hawkish
덜/MAG;완화/NNG,24,6,30,3.6255232727926976,Hawkish
평잔/NNG,68,39,107,1.5803562983968167,Hawkish
고물가/NNG;고금리/NNG,49,21,70,2.11488857579574,Hawkish
기대/NNG;인플레이션/NNG;오르/VV,31,18,49,1.560989186896856,Hawkish
일드/NNG,145,83,228,1.5834363691413893,Hawkish
분량/NNG,12,6,18,1.8127616363963488,Hawkish
지정학/NNG,2006,1176,3182,1.54608836845709,Hawkish
글로벌/NNG;위험/NNG,29,15,44,1.7523362485164709,Hawkish
공급망/NNG,489,276,765,1.6058703626772004,Hawkish
교외/NNG,16,5,21,2.9004186182341583,Hawkish
여겼/VV,11,6,17,1.661698166696653,Hawkish
도미노/NNG,13,6,19,1.9638251060960445,Hawkish
신장/NNG,98,14,112,6.344665727387222,Hawkish
디폴트/NNG;우려/NNG,28,13,41,1.9522048391960678,Hawkish
인하/NNG;가능성/NNG;낮/VV,12,6,18,1.8127616363963488,Hawkish
무역/NNG;적자/NNG;확대/NNG,15,9,24,1.5106346969969573,Hawkish
화정/NNG,198,119,317,1.508095815153265,Hawkish
회귀분석/NNG,15,6,21,2.265952045495436,Hawkish
걱정거리/NNG,25,11,36,2.059956404995851,Hawkish
인플레이션/NNG;개선/NNG,32,14,46,2.0717275844529706,Hawkish
자산효과/NNG,26,16,42,1.4728688295720334,Hawkish
잘못/MAG,94,64,158,1.3312468267285689,Hawkish
불불불/MAG,27,15,42,1.631485472756714,Hawkish
수익성/NNG;부진/NNG,20,12,32,1.5106346969969575,Hawkish
월비/NNG,767,471,1238,1.4759959396135878,Hawkish
진화/NNG,100,63,163,1.4386997114256737,Hawkish
대손충당금비율/NNG,46,13,59,3.2071936643935404,Hawkish
지수/NNG;금리/NNG;인하/NNG,12,5,17,2.1753139636756185,Hawkish
국고채/NNG;금리/NNG;내외/NNG;상승/NNG,12,8,20,1.3595712272972615,Hawkish
저항/NNG,144,90,234,1.4502093091170791,Hawkish
시시/NNG,64,39,103,1.4873941631970042,Hawkish
치우쳐져/VV,13,4,17,2.9457376591440667,Hawkish
불평등/NNG,58,24,82,2.1904203106455884,Hawkish
공급/NNG;흡수/NNG,45,27,72,1.5106346969969573,Hawkish
적립금/NNG,78,45,123,1.5710600848768357,Hawkish
각비/NNG,18,7,25,2.3306935325095917,Hawkish
항공료/NNG,13,9,22,1.309216737397363,Hawkish
보험료/NNG,204,142,346,1.302124555721321,Hawkish
테일/NNG,64,37,101,1.5677938476941395,Hawkish
유동화채권/NNG,16,3,19,4.834031030390264,Hawkish
공석/NNG,79,47,126,1.5234911625033143,Hawkish
만기상환/NNG,54,32,86,1.5295176307094194,Hawkish
가졌/VV,57,23,80,2.246248114665041,Hawkish
성립/NNG,35,19,54,1.6696488756282162,Hawkish
재정/NNG;위험/NNG,13,8,21,1.4728688295720334,Hawkish
삼우/NNG,49,13,62,3.4163584685931188,Hawkish
자체사업/NNG,24,14,38,1.5537956883397277,Hawkish
할지라도/VV,14,8,22,1.5861664318468052,Hawkish
물가/NNG;상승/NNG;위험/NNG,21,9,30,2.1148885757957405,Hawkish
경계선/NNG,18,8,26,2.0393568409458926,Hawkish
보장성보험/NNG,31,12,43,2.3414837803452837,Hawkish
매매가격지수/NNG,25,8,33,2.832440056869295,Hawkish
금리/NNG;하락/NNG;지지/NNG,11,7,18,1.424312714311417,Hawkish
낮/VA;둔화/NNG,22,3,25,6.646792666786612,Hawkish
소수점/NNG,27,14,41,1.7480201493821939,Hawkish
패턴/NNG,989,580,1569,1.545535567582749,Hawkish
사기/NNG,223,145,368,1.3939511893668475,Hawkish
퇴직자/NNG,12,8,20,1.3595712272972615,Hawkish
담대/NNG,53,24,77,2.0015909735209685,Hawkish
금리/NNG;하방/NNG;경직/NNG;강화/NNG,18,10,28,1.631485472756714,Hawkish
수요조사/NNG,13,9,22,1.309216737397363,Hawkish
취약성지수/NNG,25,7,32,3.237074350707766,Hawkish
옵션시장/NNG,19,8,27,2.1526544432206642,Hawkish
주택도시기금/NNG,47,18,65,2.3666610252952336,Hawkish
기대/NNG;위험/NNG,26,14,40,1.6832786623680382,Hawkish
수익형/NNG,20,5,25,3.625523272792698,Hawkish
치의/NNG,15,9,24,1.5106346969969573,Hawkish
시행사/NNG,82,31,113,2.397523454588719,Hawkish
할증/NNG,91,50,141,1.6496130891206775,Hawkish
국채/NNG;금리/NNG;변동성/NNG;확대/NNG,26,17,43,1.3862294866560314,Hawkish
롱재료/NNG,12,7,19,1.5537956883397277,Hawkish
외환당국/NNG,455,218,673,1.8917581297255477,Hawkish
용어/NNG,56,36,92,1.4099257171971604,Hawkish
조화/NNG,56,37,93,1.3718196167323722,Hawkish
승압/NNG,30,16,46,1.699464034121577,Hawkish
순환변동/NNG,44,27,71,1.4770650370636915,Hawkish
정면/NNG,17,11,28,1.4007703553971786,Hawkish
에쿼티/NNG,14,6,20,2.1148885757957405,Hawkish
월경/NNG,13,6,19,1.9638251060960445,Hawkish
달러원/NNG;오르/VV,25,15,40,1.5106346969969575,Hawkish
통화/NNG;약세/NNG,113,63,176,1.6257306739110111,Hawkish
매출채권/NNG,59,29,88,1.8440161473686996,Hawkish
아마/MAG,52,36,88,1.309216737397363,Hawkish
이율/NNG,432,274,706,1.4290383702978517,Hawkish
기대/NNG;넘/VV,19,11,30,1.5655668677968468,Hawkish
기한/VV,14,5,19,2.5378662909548884,Hawkish
아시아개발은행/NNG,37,8,45,4.192011284166556,Hawkish
물가/NNG;고점/NNG,46,15,61,2.779567842474402,Hawkish
편법/NNG,16,10,26,1.4502093091170791,Hawkish
폭발음/NNG,22,1,23,19.940378000359836,Hawkish
강경/NNG,145,84,229,1.5645859361754202,Hawkish
굴러떨어졌/VV,23,4,27,5.211689704639503,Hawkish
주택저당증권/NNG,35,24,59,1.3218053598723376,Hawkish
학습효과/NNG,91,48,139,1.718346967834039,Hawkish
심정/NNG,13,7,20,1.6832786623680382,Hawkish
긴축/NNG;경계/NNG,90,44,134,1.853960764496266,Hawkish
양호/NNG;경기/NNG;둔화/NNG,24,14,38,1.5537956883397277,Hawkish
따따따따/MAG,27,18,45,1.3595712272972618,Hawkish
긴축/NNG;우려/NNG;완화/NNG,14,7,21,1.812761636396349,Hawkish
고용시장/NNG;둔화/NNG,96,55,151,1.5820465190368136,Hawkish
추정손실/NNG,21,7,28,2.7191424545945235,Hawkish
은행/NNG;자본/NNG;확충/NNG,24,14,38,1.5537956883397277,Hawkish
대용/NNG,22,10,32,1.9940378000359835,Hawkish
oecd/NNG,751,475,1226,1.4330357778249032,Hawkish
파트장/NNG,18,1,19,16.31485472756714,Hawkish
항만/NNG,37,19,56,1.765057382806971,Hawkish
경기민감도/NNG,20,9,29,2.0141795959959437,Hawkish
긴급회의/NNG,27,10,37,2.447228209135071,Hawkish
삼정/NNG,13,7,20,1.6832786623680382,Hawkish
세심/NNG,23,16,39,1.3029224261598757,Hawkish
속속/MAG,515,283,798,1.649420923576183,Hawkish
신혼/NNG,45,27,72,1.5106346969969573,Hawkish
링컨/NNG,15,3,18,4.531904090990872,Hawkish
물음표/NNG,17,8,25,1.9260592386711206,Hawkish
심리/NNG;강하/VA,28,15,43,1.6919108606365922,Hawkish
요양/NNG,15,6,21,2.265952045495436,Hawkish
완화/NNG;전환/NNG,24,16,40,1.3595712272972615,Hawkish
재판부/NNG,12,7,19,1.5537956883397277,Hawkish
위험/NNG;크/VV,61,37,98,1.4943035110834768,Hawkish
덧붙임/NNG,17,9,26,1.7120526565965517,Hawkish
물물/NNG,747,505,1252,1.3407256855327452,Hawkish
순이자/NNG,118,64,182,1.671139633552884,Hawkish
예상/NNG;개선/NNG,18,9,27,1.812761636396349,Hawkish
외국은행/NNG,32,18,50,1.6113436767967546,Hawkish
당히/VV,13,9,22,1.309216737397363,Hawkish
선형/NNG,53,36,89,1.3343939823473125,Hawkish
이너/NNG,21,3,24,6.344665727387221,Hawkish
가격변수/NNG;변동성/NNG;확대/NNG,29,18,47,1.460280207097059,Hawkish
용지/NNG,52,33,85,1.4282364407971233,Hawkish
야대/NNG,37,14,51,2.3954350195237466,Hawkish
환경부/NNG,36,17,53,1.9193946738314283,Hawkish
어서/MAG,37,25,62,1.3414436109332981,Hawkish
맞춰야/VV,26,14,40,1.6832786623680382,Hawkish
장장/NNG,55,24,79,2.0771227083708164,Hawkish
가든/NNG,16,7,23,2.0717275844529706,Hawkish
세계/NNG;경제/NNG;둔화/NNG,16,8,24,1.8127616363963488,Hawkish
손해율/NNG,107,51,158,1.9016225009255816,Hawkish
목적지/NNG,25,15,40,1.5106346969969575,Hawkish
관리국/NNG,16,8,24,1.8127616363963488,Hawkish
대체에너지/NNG,15,3,18,4.531904090990872,Hawkish
수요/NNG;충격/NNG,11,6,17,1.661698166696653,Hawkish
공모주/NNG,103,20,123,4.667861213720599,Hawkish
드립니다/VV,33,23,56,1.3004594348060765,Hawkish
장기전/NNG,77,44,121,1.5861664318468054,Hawkish
노바/NNG,35,4,39,7.9308321592340265,Hawkish
포지셔닝/NNG,23,10,33,2.084675881855801,Hawkish
국고채/NNG;금리/NNG;고점/NNG,17,9,26,1.7120526565965517,Hawkish
채굴/NNG,105,63,168,1.5106346969969575,Hawkish
수익성/NNG;양호/NNG,13,8,21,1.4728688295720334,Hawkish
수요/NNG;완화/NNG,15,7,22,1.9422446104246596,Hawkish
실선/NNG,21,6,27,3.1723328636936103,Hawkish
종국/NNG,47,26,73,1.6384576328967,Hawkish
실차/NNG,21,13,34,1.464153629397051,Hawkish
기대/NNG;인플레이션/NNG;안정/NNG,56,12,68,4.229777151591481,Hawkish
견제구/NNG,13,9,22,1.309216737397363,Hawkish
재소/NNG,44,28,72,1.424312714311417,Hawkish
뭉칫돈/NNG,35,23,58,1.3792751581276568,Hawkish
선택법/NNG,21,7,28,2.7191424545945235,Hawkish
선제/NNG;금리/NNG;인상/NNG,33,21,54,1.424312714311417,Hawkish
인하/NNG;기대/NNG;크/VV,16,8,24,1.8127616363963488,Hawkish
세대수/NNG,16,4,20,3.6255232727926976,Hawkish
기준선/NNG,225,101,326,2.019165189055339,Hawkish
견조/NNG;회복/NNG,14,7,21,1.812761636396349,Hawkish
미확보/NNG,19,1,20,17.221235545765314,Hawkish
모상/NNG,31,1,32,28.097805364143408,Hawkish
물가/NNG;성장/NNG,59,36,95,1.485457452047008,Hawkish
주연/NNG,15,2,17,6.797856136486308,Hawkish
신용스프레드/NNG;소폭/MAG;축소/NNG,12,8,20,1.3595712272972615,Hawkish
한미/NNG;금리갭/NNG;확대/NNG,15,8,23,1.699464034121577,Hawkish
노트/NNG,71,49,120,1.3133273080014365,Hawkish
구속/NNG,32,15,47,1.9336124121561056,Hawkish
수협/NNG,63,28,91,2.0393568409458926,Hawkish
충돌/NNG,218,116,334,1.7033708479931209,Hawkish
낮/VA;물가/NNG;상승/NNG,12,6,18,1.8127616363963488,Hawkish
지출/NNG;확대/NNG,40,19,59,1.9081701435751042,Hawkish
브릿지론/NNG,372,153,525,2.203749440324973,Hawkish
환경/NNG;위축/NNG,25,7,32,3.237074350707766,Hawkish
소비자/NNG;물가/NNG;상승/NNG;둔화/NNG,21,3,24,6.344665727387221,Hawkish
소비성향/NNG,70,43,113,1.4755036575319118,Hawkish
승부수/NNG,14,5,19,2.5378662909548884,Hawkish
미/NNG;국채/NNG;하락/NNG,19,12,31,1.4351029621471094,Hawkish
증축/NNG,11,7,18,1.424312714311417,Hawkish
금리/NNG;부담/NNG;완화/NNG,19,8,27,2.1526544432206642,Hawkish
지닌/VV,62,37,99,1.5188002899536976,Hawkish
과반/NNG,70,46,116,1.3792751581276568,Hawkish
동취/NNG,77,12,89,5.815943583438286,Hawkish
pf/NNG;위험/NNG,31,19,50,1.4788318612707056,Hawkish
원가/NNG;상승/NNG,44,26,70,1.5338752307969103,Hawkish
잘못/NNG,20,10,30,1.812761636396349,Hawkish
파산/NNG,595,351,946,1.5364575123302386,Hawkish
엔지니어/NNG,12,5,17,2.1753139636756185,Hawkish
회복/NNG;쉽/VA;않/VX,17,11,28,1.4007703553971786,Hawkish
소재산업/NNG,21,10,31,1.9033997182161664,Hawkish
민평/NNG;금리/NNG;높/VA,12,7,19,1.5537956883397277,Hawkish
원자재/NNG;상승/NNG,20,10,30,1.812761636396349,Hawkish
채권/NNG;금리/NNG;소폭/MAG;상승/NNG,12,7,19,1.5537956883397277,Hawkish
트레저리/NNG,13,8,21,1.4728688295720334,Hawkish
수수료이익/NNG,12,5,17,2.1753139636756185,Hawkish
신흥국/NNG;위험/NNG,18,11,29,1.4831686115970129,Hawkish
안정/NNG;부정적/VAX;안정/NNG,20,13,33,1.3944320279971913,Hawkish
일시불/NNG,12,8,20,1.3595712272972615,Hawkish
물가/NNG;상방/NNG;압력/NNG,76,34,110,2.0260277112665075,Hawkish
높/VA;인상/NNG,31,17,48,1.6528120802437296,Hawkish
채권/NNG;높/VA,18,9,27,1.812761636396349,Hawkish
여유자금/NNG,71,38,109,1.6935010024229047,Hawkish
농축/NNG,33,4,37,7.477641750134939,Hawkish
물가/NNG;상승률/NNG;국제/NNG;유가/NNG;하락/NNG,17,8,25,1.9260592386711206,Hawkish
예상/NNG;상승/NNG;웃돌/VV,37,17,54,1.9727111925489675,Hawkish
물가/NNG;상승/NNG;압력/NNG;둔화/NNG,15,3,18,4.531904090990872,Hawkish
대동소이/NNG,13,8,21,1.4728688295720334,Hawkish
칭하/VV,11,6,17,1.661698166696653,Hawkish
중국은행/NNG,116,46,162,2.2856559763258315,Hawkish
프라이빗/NNG,20,12,32,1.5106346969969575,Hawkish
달인/NNG,13,8,21,1.4728688295720334,Hawkish
글로벌/NNG;국채/NNG;금리/NNG;상승/NNG,27,18,45,1.3595712272972618,Hawkish
ira/NNG,102,34,136,2.719142454594523,Hawkish
내외/NNG;금리갭/NNG;확대/NNG,27,18,45,1.3595712272972618,Hawkish
유기/NNG,21,11,32,1.7303633801965148,Hawkish
두드리/VV,54,15,69,3.262970945513428,Hawkish
국책연구기관/NNG,15,7,22,1.9422446104246596,Hawkish
인하/NNG;가능성/NNG;후퇴/NNG,16,3,19,4.834031030390264,Hawkish
임금/NNG;높/VA,13,4,17,2.9457376591440667,Hawkish
가격/NNG;오름/NNG;확대/NNG,18,5,23,3.262970945513428,Hawkish
가이드/NNG,17,10,27,1.5408473909368965,Hawkish
망은/NNG,15,9,24,1.5106346969969573,Hawkish
연방법원/NNG,14,5,19,2.5378662909548884,Hawkish
영사관/NNG,135,33,168,3.707921528992532,Hawkish
소비/NNG;부정적/VAX,13,4,17,2.9457376591440667,Hawkish
골칫거리/NNG,13,5,18,2.3565901273152536,Hawkish
황황/NNG,262,81,343,2.9317503008385395,Hawkish
퇴조/NNG,14,4,18,3.1723328636936103,Hawkish
재정/NNG;지출/NNG;확대/NNG,54,36,90,1.3595712272972618,Hawkish
요구불/NNG,24,16,40,1.3595712272972615,Hawkish
대응력/NNG,81,47,128,1.5620605590223857,Hawkish
혁혁/NNG,20,11,31,1.647965123996681,Hawkish
여러모로/MAG,12,7,19,1.5537956883397277,Hawkish
종착역/NNG,28,3,31,8.459554303182962,Hawkish
부동산/NNG;연착륙/NNG,27,10,37,2.447228209135071,Hawkish
속내/NNG,23,13,36,1.6035968321967702,Hawkish
고환/NNG,110,47,157,2.1213168085489187,Hawkish
경기/NNG;침체/NNG;아니/VCN,17,7,24,2.201210558481281,Hawkish
책무/NNG,148,79,227,1.6980298872573392,Hawkish
균열/NNG,52,35,87,1.3466229298944306,Hawkish
베이비붐세대/NNG,20,11,31,1.647965123996681,Hawkish
저점/NNG;고점/NNG,42,29,71,1.3126894608387354,Hawkish
복귀전/NNG,27,4,31,6.1180705228376775,Hawkish
듀레이션/NNG;짧/VA,24,15,39,1.4502093091170791,Hawkish
제스처/NNG,12,8,20,1.3595712272972615,Hawkish
은행/NNG;시스템/NNG;위험/NNG,16,9,25,1.6113436767967546,Hawkish
점자/NNG,24,2,26,10.876569818378092,Hawkish
수익/NNG;감소/NNG,33,22,55,1.3595712272972618,Hawkish
세액공제/NNG,56,31,87,1.6373330909386377,Hawkish
전통/NNG,68,35,103,1.7609684467850246,Hawkish
명확/NNG,490,340,830,1.3062547085797218,Hawkish
일계/NNG,11,6,17,1.661698166696653,Hawkish
가피/NNG,33,21,54,1.424312714311417,Hawkish
통영/NNG,27,4,31,6.1180705228376775,Hawkish
민영/NNG,30,6,36,4.531904090990872,Hawkish
외식/NNG,162,85,247,1.7274552064482853,Hawkish
원유/NNG;재고/NNG;증가/NNG,20,10,30,1.812761636396349,Hawkish
돌발/NNG,42,14,56,2.7191424545945235,Hawkish
섹터전략/NNG,13,4,17,2.9457376591440667,Hawkish
인지/NNG,167,109,276,1.3886751985238086,Hawkish
하늘/NNG,29,15,44,1.7523362485164709,Hawkish
우드/NNG,29,20,49,1.314252186387353,Hawkish
하락/NNG;줄/VV,24,10,34,2.1753139636756185,Hawkish
원달러/NNG;안정/NNG,15,6,21,2.265952045495436,Hawkish
사로/NNG,18,7,25,2.3306935325095917,Hawkish
완화/NNG;지연/NNG,12,6,18,1.8127616363963488,Hawkish
국민은행채/NNG,21,2,23,9.516998591080831,Hawkish
성수/NNG,23,16,39,1.3029224261598757,Hawkish
행정리/NNG,14,3,17,4.229777151591481,Hawkish
실적발표/NNG,465,299,764,1.4095888978667264,Hawkish
비로소/MAG,22,11,33,1.8127616363963488,Hawkish
pmi/NNG;부진/NNG,19,10,29,1.7221235545765314,Hawkish
미/NNG;fed/NNG;금리/NNG;인상/NNG,13,8,21,1.4728688295720334,Hawkish
보였었/VV,14,8,22,1.5861664318468052,Hawkish
전운/NNG,18,9,27,1.812761636396349,Hawkish
대변/NNG,70,39,109,1.6268373659967232,Hawkish
공실률/NNG,141,66,207,1.9363590206960999,Hawkish
대학살/NNG,17,10,27,1.5408473909368965,Hawkish
먹히/VV,15,7,22,1.9422446104246596,Hawkish
임차료/NNG,34,15,49,2.054463187915862,Hawkish
입히/VV,19,9,28,1.9134706161961461,Hawkish
수장/NNG,50,34,84,1.332912967938492,Hawkish
인력난/NNG,17,5,22,3.081694781873793,Hawkish
대출/NNG;금리/NNG;인상/NNG,22,12,34,1.661698166696653,Hawkish
고용시장/NNG;인플레이션/NNG;압력/NNG,22,15,37,1.3293585333573226,Hawkish
연천/NNG,13,7,20,1.6832786623680382,Hawkish
성장/NNG;전망/NNG;하향/NNG,23,8,31,2.6058448523197515,Hawkish
변경상장/NNG,13,5,18,2.3565901273152536,Hawkish
자본자유화/NNG,17,7,24,2.201210558481281,Hawkish
소비/NNG;지출/NNG;pce/NNG;물가/NNG;상승/NNG,33,3,36,9.97018900017992,Hawkish
산업/NNG;생산/NNG;부진/NNG,18,6,24,2.7191424545945235,Hawkish
지급여력/NNG,22,14,36,1.424312714311417,Hawkish
외국환/NNG,14,8,22,1.5861664318468052,Hawkish
알알/NNG,18,11,29,1.4831686115970129,Hawkish
다각도/NNG,15,10,25,1.3595712272972615,Hawkish
접점/NNG,20,11,31,1.647965123996681,Hawkish
음식료품/NNG,37,25,62,1.3414436109332981,Hawkish
이듬해/NNG,30,15,45,1.8127616363963488,Hawkish
전망/NNG;경로/NNG;상회/NNG,22,12,34,1.661698166696653,Hawkish
하락/NNG;제한적/VAX,33,21,54,1.424312714311417,Hawkish
최상/NNG,18,10,28,1.631485472756714,Hawkish
하인/NNG,32,9,41,3.222687353593509,Hawkish
철저/NNG,45,31,76,1.3157140909328338,Hawkish
재기/NNG,17,10,27,1.5408473909368965,Hawkish
근로자수/NNG,20,9,29,2.0141795959959437,Hawkish
서기/NNG,11,7,18,1.424312714311417,Hawkish
성장/NNG;약화/NNG,49,28,77,1.5861664318468054,Hawkish
뱅크런/NNG,80,52,132,1.3944320279971913,Hawkish
외식업/NNG,18,5,23,3.262970945513428,Hawkish
의제/NNG,40,27,67,1.3427863973306289,Hawkish
유가/NNG;원자재/NNG;가격/NNG;하락/NNG,13,5,18,2.3565901273152536,Hawkish
협력사/NNG,67,21,88,2.8917864199656043,Hawkish
만만/MAG,17,11,28,1.4007703553971786,Hawkish
국민연금기금/NNG,25,9,34,2.5177244949949293,Hawkish
후발주자/NNG,19,9,28,1.9134706161961461,Hawkish
경제/NNG;수출/NNG;증가/NNG,21,3,24,6.344665727387221,Hawkish
gdp/NNG;상향/NNG,12,7,19,1.5537956883397277,Hawkish
물가/NNG;상승률/NNG;하락/NNG,36,25,61,1.3051883782053713,Hawkish
물가/NNG;상승률/NNG;농산물/NNG;가격/NNG;상승/NNG,13,6,19,1.9638251060960445,Hawkish
투자/NNG;수요/NNG;감소/NNG,13,8,21,1.4728688295720334,Hawkish
진심/NNG,26,15,41,1.5710600848768357,Hawkish
통화정책/NNG;긴축/NNG,102,57,159,1.6219446220388383,Hawkish
연계금융/NNG,20,2,22,9.063808181981745,Hawkish
여럿/NNG,14,3,17,4.229777151591481,Hawkish
소득/NNG;늘/VV,13,8,21,1.4728688295720334,Hawkish
금리/NNG;만장일치/NNG;인상/NNG,19,8,27,2.1526544432206642,Hawkish
종료/NNG;인상/NNG,16,8,24,1.8127616363963488,Hawkish
자회/NNG,14,4,18,3.1723328636936103,Hawkish
물가/NNG;급등/NNG,37,22,59,1.5243677396969297,Hawkish
양적완화/NNG;종료/NNG,16,10,26,1.4502093091170791,Hawkish
추적오차/NNG,28,14,42,1.812761636396349,Hawkish
전망/NNG;회복/NNG,17,11,28,1.4007703553971786,Hawkish
지우/VV,23,12,35,1.737229901546501,Hawkish
물가/NNG;상승률/NNG;하향/NNG,14,5,19,2.5378662909548884,Hawkish
교차/NNG,41,26,67,1.4292928286971212,Hawkish
시스템/NNG;위험/NNG;우려/NNG,11,7,18,1.424312714311417,Hawkish
비춰/VV,19,12,31,1.4351029621471094,Hawkish
행대/NNG,20,9,29,2.0141795959959437,Hawkish
평했/VV,12,5,17,2.1753139636756185,Hawkish
비치/NNG,16,8,24,1.8127616363963488,Hawkish
하하하/MAG,1065,511,1576,1.8890324293171348,Hawkish
강하/VA;회복/NNG,19,13,32,1.3247104265973317,Hawkish
치마/NNG,59,23,82,2.3250638379866215,Hawkish
원화자산/NNG,43,21,64,1.855922627739119,Hawkish
내부거래/NNG,24,6,30,3.6255232727926976,Hawkish
신용등급/NNG;전망/NNG;안정/NNG,15,9,24,1.5106346969969573,Hawkish
쿠폰/NNG,196,109,305,1.6298223886866257,Hawkish
하방/NNG;압력/NNG;높/VA,19,12,31,1.4351029621471094,Hawkish
영농/NNG,22,6,28,3.323396333393306,Hawkish
벌리/VV,16,6,22,2.417015515195132,Hawkish
광산업/NNG,23,10,33,2.084675881855801,Hawkish
트리플/NNG,24,14,38,1.5537956883397277,Hawkish
선성/NNG,176,64,240,2.4925472500449795,Hawkish
금리/NNG;인상/NNG;불가능/NNG,12,5,17,2.1753139636756185,Hawkish
재정위기/NNG;우려/NNG,25,8,33,2.832440056869295,Hawkish
시스템/NNG;위험/NNG;확산/NNG,15,10,25,1.3595712272972615,Hawkish
인플레이션/NNG;하방/NNG,20,2,22,9.063808181981745,Hawkish
소용돌이/NNG,21,8,29,2.379249647770208,Hawkish
국제/NNG;금융시장/NNG;fed/NNG;금리/NNG;인상/NNG,25,7,32,3.237074350707766,Hawkish
직구/NNG,35,11,46,2.8839389669941915,Hawkish
스퀴즈/NNG,16,3,19,4.834031030390264,Hawkish
표했/VV,34,18,52,1.7120526565965517,Hawkish
경기순환시계/NNG,24,10,34,2.1753139636756185,Hawkish
둔화/NNG;금리/NNG;인하/NNG,29,15,44,1.7523362485164709,Hawkish
입소문/NNG,24,5,29,4.350627927351237,Hawkish
식순/NNG,15,8,23,1.699464034121577,Hawkish
기운/NNG,19,13,32,1.3247104265973317,Hawkish
개의/NNG,15,9,24,1.5106346969969573,Hawkish
농촌/NNG,38,17,55,2.0260277112665075,Hawkish
유조선/NNG,19,7,26,2.460176506537902,Hawkish
종료/NNG;금리/NNG;인하/NNG,13,5,18,2.3565901273152536,Hawkish
파업/NNG,138,88,226,1.4213699194471374,Hawkish
규모의경제/NNG,17,10,27,1.5408473909368965,Hawkish
사업경쟁력/NNG,94,42,136,2.0285665931102,Hawkish
대외/NNG;악재/NNG,11,7,18,1.424312714311417,Hawkish
국고채/NNG;금리/NNG;인상/NNG,26,18,44,1.309216737397363,Hawkish
위험/NNG;선호/NNG;살/VV,17,10,27,1.5408473909368965,Hawkish
금리/NNG;인하/NNG;불확실성/NNG,91,34,125,2.425901601648055,Hawkish
말씀/NNG,396,230,626,1.5605513217672915,Hawkish
호스/NNG,13,5,18,2.3565901273152536,Hawkish
지분가치/NNG,26,13,39,1.8127616363963488,Hawkish
은행/NNG;대출태도/NNG;강화/NNG,19,12,31,1.4351029621471094,Hawkish
감원계획/NNG,74,30,104,2.235739351555497,Hawkish
중간배당/NNG,15,10,25,1.3595712272972615,Hawkish
정점/NNG,697,443,1140,1.4260664340499494,Hawkish
연차/NNG,75,20,95,3.3989280682431544,Hawkish
스트레스테스트/NNG,134,84,218,1.4458932099828021,Hawkish
청청/NNG,12,5,17,2.1753139636756185,Hawkish
처분가능/NNG,56,27,83,1.8799009562628803,Hawkish
출비/NNG,13,8,21,1.4728688295720334,Hawkish
pf/NNG,3991,2603,6594,1.3896910662423796,Hawkish
전순/NNG,17,3,20,5.136157969789655,Hawkish
내전/NNG,21,9,30,2.1148885757957405,Hawkish
대리인/NNG,24,9,33,2.417015515195132,Hawkish
독점/NNG,73,31,104,2.1343806364021525,Hawkish
준비금/NNG,832,565,1397,1.3347059128157188,Hawkish
금리/NNG;인상/NNG;아니/VCN,21,14,35,1.3595712272972618,Hawkish
금리/NNG;내리/VV;하락/NNG,13,9,22,1.309216737397363,Hawkish
앞섰/VV,19,10,29,1.7221235545765314,Hawkish
고용주/NNG,26,16,42,1.4728688295720334,Hawkish
가계/NNG;대출/NNG;감소/NNG,43,23,66,1.6945380514139783,Hawkish
사업보고서/NNG,57,31,88,1.666571181848256,Hawkish
주년/NNG,145,91,236,1.444233171854234,Hawkish
부동산/NNG;위축/NNG,23,14,37,1.4890542013255725,Hawkish
정책/NNG;불확실성/NNG;해소/NNG,14,7,21,1.812761636396349,Hawkish
기관채/NNG,204,112,316,1.6509079188609606,Hawkish
할당/NNG,57,38,95,1.3595712272972618,Hawkish
지수/NNG;급락/NNG,44,25,69,1.5952302400287868,Hawkish
이라크전쟁/NNG,15,4,19,3.398928068243154,Hawkish
국고채/NNG;발행/NNG;축소/NNG,17,4,21,3.852118477342241,Hawkish
베팅/NNG,1212,747,1959,1.47059377731752,Hawkish
시추/NNG,92,44,136,1.895159892596183,Hawkish
가격/NNG;높/VA,56,32,88,1.5861664318468052,Hawkish
위험/NNG;증가/NNG,39,24,63,1.4728688295720336,Hawkish
취임식/NNG,32,12,44,2.417015515195132,Hawkish
위험/NNG;불확실성/NNG,13,6,19,1.9638251060960445,Hawkish
수출/NNG;증가율/NNG;둔화/NNG,18,7,25,2.3306935325095917,Hawkish
장마감후/NNG,307,205,512,1.3573605423748272,Hawkish
기대/NNG;강세/NNG,29,19,48,1.3834233540919505,Hawkish
공급/NNG;불확실성/NNG,14,8,22,1.5861664318468052,Hawkish
유의미/NNG,85,49,134,1.5722932560580576,Hawkish
물가/NNG;당분간/MAG;높/VA,14,5,19,2.5378662909548884,Hawkish
대출/NNG;이자/NNG;부담/NNG,17,6,23,2.5680789848948273,Hawkish
주주환원정책/NNG,50,30,80,1.5106346969969575,Hawkish
남녀/NNG,15,9,24,1.5106346969969573,Hawkish
이민자/NNG,23,10,33,2.084675881855801,Hawkish
전가/NNG,130,71,201,1.6595705121938404,Hawkish
고임금/NNG,19,5,24,3.444247109153063,Hawkish
대어/NNG,18,6,24,2.7191424545945235,Hawkish
물가/NNG;전망/NNG;상향/NNG,92,49,141,1.7017762300863684,Hawkish
미처/MAG,13,9,22,1.309216737397363,Hawkish
애널리틱스/NNG,16,8,24,1.8127616363963488,Hawkish
이렇/VA,69,46,115,1.3595712272972618,Hawkish
실적/NNG;하락/NNG,14,6,20,2.1148885757957405,Hawkish
민간/NNG;소비/NNG;증가/NNG,15,10,25,1.3595712272972615,Hawkish
장기보유/NNG,12,7,19,1.5537956883397277,Hawkish
헤즈볼라/NNG,14,4,18,3.1723328636936103,Hawkish
노린다/VV,13,6,19,1.9638251060960445,Hawkish
주거/NNG,629,349,978,1.6335631365233574,Hawkish
운용부/NNG,14,4,18,3.1723328636936103,Hawkish
구조조정기금/NNG,18,7,25,2.3306935325095917,Hawkish
건과/NNG,11,7,18,1.424312714311417,Hawkish
대출태도/NNG;강화/NNG,22,12,34,1.661698166696653,Hawkish
예상/NNG;웃돌/VV;상승/NNG,26,18,44,1.309216737397363,Hawkish
축축/MAG,262,153,415,1.5521031004439327,Hawkish
개요/NNG,121,62,183,1.768904500031921,Hawkish
굴곡/NNG,18,6,24,2.7191424545945235,Hawkish
비리/NNG,33,22,55,1.3595712272972618,Hawkish
하비/NNG,16,8,24,1.8127616363963488,Hawkish
유예/NNG,340,193,533,1.5967330476030015,Hawkish
gdp/NNG;성장률/NNG;하향/NNG,13,9,22,1.309216737397363,Hawkish
색채/NNG,60,37,97,1.4698067322132558,Hawkish
에틸/NNG,20,4,24,4.5319040909908725,Hawkish
상대강도/NNG,27,14,41,1.7480201493821939,Hawkish
잡잡/NNG,18,7,25,2.3306935325095917,Hawkish
버팀목/NNG,45,24,69,1.699464034121577,Hawkish
건설/NNG;경기/NNG;회복/NNG,11,6,17,1.661698166696653,Hawkish
국고채/NNG;통안채/NNG;스프레드/NNG;축소/NNG,48,22,70,1.977558148796017,Hawkish
위험/NNG;금융안정/NNG,29,19,48,1.3834233540919505,Hawkish
지속성/NNG,248,153,401,1.469166293549982,Hawkish
중장기물/NNG;강세/NNG,14,4,18,3.1723328636936103,Hawkish
인적/NNG,21,4,25,4.758499295540416,Hawkish
예상/NNG;넘/VV,81,37,118,1.9842390884878953,Hawkish
적대적/VAX,13,9,22,1.309216737397363,Hawkish
전문기업/NNG,29,17,46,1.5461790428086506,Hawkish
운용자산/NNG,183,101,284,1.6422543537650092,Hawkish
헬리콥터머니/NNG,14,5,19,2.5378662909548884,Hawkish
제때/NNG,21,9,30,2.1148885757957405,Hawkish
경제/NNG;예상/NNG;양호/NNG,24,12,36,1.8127616363963488,Hawkish
영광/NNG,11,7,18,1.424312714311417,Hawkish
국고채/NNG;약세/NNG,15,8,23,1.699464034121577,Hawkish
짐짐/NNG,49,2,51,22.206330045855275,Hawkish
어렵/VA;인하/NNG,13,9,22,1.309216737397363,Hawkish
직급/NNG,177,68,245,2.3592559532511306,Hawkish
미일/NNG,152,81,233,1.7008627699521297,Hawkish
더디/VA;회복/NNG,28,17,45,1.4928625240911106,Hawkish
은행채/NNG;금리/NNG;상승/NNG,14,5,19,2.5378662909548884,Hawkish
환경문제/NNG,12,7,19,1.5537956883397277,Hawkish
금리/NNG;인상/NNG;인하/NNG,41,21,62,1.7696006450535784,Hawkish
폭격/NNG,123,23,146,4.847166984277194,Hawkish
fed/NNG;긴축/NNG;종료/NNG,16,6,22,2.417015515195132,Hawkish
트위스트/NNG,13,5,18,2.3565901273152536,Hawkish
원제/NNG,57,20,77,2.5831853318647973,Hawkish
금리/NNG;고공행진/NNG,12,8,20,1.3595712272972615,Hawkish
경기/NNG;부정적/VAX,29,18,47,1.460280207097059,Hawkish
전표/NNG,34,14,48,2.201210558481281,Hawkish
평등/NNG,21,7,28,2.7191424545945235,Hawkish
보이콧/NNG,15,7,22,1.9422446104246596,Hawkish
대출/NNG;금리/NNG;낮/VV,11,6,17,1.661698166696653,Hawkish
최대/NNG;확대/NNG,15,8,23,1.699464034121577,Hawkish
의원실/NNG,20,11,31,1.647965123996681,Hawkish
금리/NNG;추세/NNG;상승/NNG,16,11,27,1.3183720991973447,Hawkish
asp/NNG,26,9,35,2.618433474794726,Hawkish
전망/NNG;지정학/NNG;위험/NNG,17,7,24,2.201210558481281,Hawkish
최종안/NNG,36,22,58,1.4831686115970129,Hawkish
격추/NNG,20,13,33,1.3944320279971913,Hawkish
최저/NNG;떨어/VV,26,16,42,1.4728688295720334,Hawkish
사이언스/NNG,54,34,88,1.4395460053735711,Hawkish
일원/NNG,23,13,36,1.6035968321967702,Hawkish
금리/NNG;많이/MAG;오르/VV,12,5,17,2.1753139636756185,Hawkish
배우/NNG,13,7,20,1.6832786623680382,Hawkish
물가/NNG;떨어/VV,22,13,35,1.5338752307969103,Hawkish
가용자금/NNG,11,6,17,1.661698166696653,Hawkish
지준율/NNG;인상/NNG,18,9,27,1.812761636396349,Hawkish
fed/NNG;통화/NNG;긴축/NNG,43,23,66,1.6945380514139783,Hawkish
명시적/VAX,60,35,95,1.5537956883397275,Hawkish
종류별/NNG,159,83,242,1.7363198806446956,Hawkish
집약/NNG,42,23,65,1.655130189753188,Hawkish
사업비율/NNG,55,22,77,2.2659520454954363,Hawkish
다주택자/NNG,29,17,46,1.5461790428086506,Hawkish
대외/NNG;통화정책/NNG;불확실성/NNG,13,8,21,1.4728688295720334,Hawkish
통화불일치/NNG,14,4,18,3.1723328636936103,Hawkish
까까/NNG,108,59,167,1.659137768905133,Hawkish
미시간대/NNG,345,196,541,1.5954152157059702,Hawkish
수요/NNG;증가/NNG;확대/NNG,17,8,25,1.9260592386711206,Hawkish
필자/NNG,88,59,147,1.3518900339227007,Hawkish
동맹국/NNG,34,16,50,1.9260592386711206,Hawkish
유가/NNG;오르/VV,44,24,68,1.661698166696653,Hawkish
컨센서스/NNG;상향/NNG,12,6,18,1.8127616363963488,Hawkish
결의안/NNG,25,13,38,1.7430400349964892,Hawkish
연면적/NNG,19,7,26,2.460176506537902,Hawkish
양극/NNG,35,22,57,1.4419694834970957,Hawkish
내준/VV,18,8,26,2.0393568409458926,Hawkish
여력/NNG;확보/NNG,37,22,59,1.5243677396969297,Hawkish
입법화/NNG,21,10,31,1.9033997182161664,Hawkish
신청자/NNG,15,10,25,1.3595712272972615,Hawkish
선제안내/NNG,13,9,22,1.309216737397363,Hawkish
선도거래/NNG,19,10,29,1.7221235545765314,Hawkish
송운/NNG,56,27,83,1.8799009562628803,Hawkish
폐쇄/NNG,374,251,625,1.3505435299048496,Hawkish
표기/NNG,86,49,135,1.590790823776388,Hawkish
신발/NNG,65,40,105,1.4728688295720334,Hawkish
망망/NNG,820,460,1280,1.6157223280923978,Hawkish
정신/NNG,33,19,52,1.574240368449461,Hawkish
정에/NNG,14,7,21,1.812761636396349,Hawkish
전망/NNG;하향/NNG,158,101,259,1.4179026660921936,Hawkish
가격/NNG;부담/NNG;높/VA,15,3,18,4.531904090990872,Hawkish
피해갈/VV,16,8,24,1.8127616363963488,Hawkish
거둘/VV,34,22,56,1.4007703553971786,Hawkish
실업수당청구/NNG,831,529,1360,1.4238231756572457,Hawkish
멈춘다면/VV,19,6,25,2.870205924294219,Hawkish
공동대표/NNG,11,7,18,1.424312714311417,Hawkish
회복/NNG;전환/NNG,12,7,19,1.5537956883397277,Hawkish
원재료/NNG,100,36,136,2.5177244949949293,Hawkish
건설/NNG;하락/NNG,15,6,21,2.265952045495436,Hawkish
교역국/NNG,20,13,33,1.3944320279971913,Hawkish
하락/NNG;견인/NNG,24,16,40,1.3595712272972615,Hawkish
고용/NNG;고용자수/NNG;증가/NNG;둔화/NNG,14,3,17,4.229777151591481,Hawkish
서도/NNG,24,16,40,1.3595712272972615,Hawkish
원서/NNG,15,2,17,6.797856136486308,Hawkish
가지/NNG,24,10,34,2.1753139636756185,Hawkish
계단식/NNG,13,6,19,1.9638251060960445,Hawkish
원전사태/NNG,16,1,17,14.50209309117079,Hawkish
계약금/NNG,36,23,59,1.418683019788447,Hawkish
통화정책방향회의/NNG,44,9,53,4.431195111191075,Hawkish
벌크/NNG,51,9,60,5.1361579697896556,Hawkish
기안/NNG,13,6,19,1.9638251060960445,Hawkish
지정학/NNG;위험/NNG;확산/NNG,16,4,20,3.6255232727926976,Hawkish
암울/NNG,26,7,33,3.3665573247360765,Hawkish
가격/NNG;인하/NNG,49,34,83,1.3062547085797218,Hawkish
각자도생/NNG,24,16,40,1.3595712272972615,Hawkish
엔저/NNG,206,138,344,1.3530032503537965,Hawkish
통방문/NNG,286,90,376,2.880276822274199,Hawkish
미실/NNG,11,6,17,1.661698166696653,Hawkish
부동산/NNG;부진/NNG,31,13,44,2.1613696433956466,Hawkish
경기선/NNG,14,8,22,1.5861664318468052,Hawkish
총계/NNG,42,24,66,1.5861664318468052,Hawkish
고찰/NNG,25,16,41,1.4162200284346476,Hawkish
연금저축/NNG,21,4,25,4.758499295540416,Hawkish
적절/NNG,1795,1231,3026,1.3216519647975005,Hawkish
레벨2/NNG,15,6,21,2.265952045495436,Hawkish
쇄신/NNG,26,11,37,2.142354661195685,Hawkish
통해/NNG,32,13,45,2.2310912447955062,Hawkish
고강/NNG,62,39,101,1.4409130955970977,Hawkish
핀다/VV,18,7,25,2.3306935325095917,Hawkish
긍정적/VAX;안정/NNG;상향/NNG,18,11,29,1.4831686115970129,Hawkish
초중/NNG,28,19,47,1.3357191005025728,Hawkish
분양시장/NNG,55,31,86,1.608095000029019,Hawkish
연금보험/NNG,26,13,39,1.8127616363963488,Hawkish
헤드라인/NNG,936,587,1523,1.445268221181416,Hawkish
이자/NNG;부담/NNG;완화/NNG,12,7,19,1.5537956883397277,Hawkish
트론/NNG,94,63,157,1.3523777287401333,Hawkish
성적/NNG,56,38,94,1.3357191005025728,Hawkish
힘쓰/VV,17,8,25,1.9260592386711206,Hawkish
사정/NNG,215,141,356,1.3820700419333865,Hawkish
방편/NNG,14,6,20,2.1148885757957405,Hawkish
fed/NNG;금리/NNG;인상/NNG;가속/NNG,15,4,19,3.398928068243154,Hawkish
초초/MAG,45,29,74,1.406452993755788,Hawkish
호반/NNG,32,11,43,2.6367441983946893,Hawkish
미사일/NNG,227,70,297,2.9392635104426517,Hawkish
감정/NNG,16,11,27,1.3183720991973447,Hawkish
당한/VV,15,7,22,1.9422446104246596,Hawkish
총파업/NNG,14,7,21,1.812761636396349,Hawkish
우수/NNG,718,483,1201,1.3473735558308266,Hawkish
진공/NNG,83,52,135,1.4467232290470862,Hawkish
bb등급/NNG,78,34,112,2.079344229984047,Hawkish
다분히/MAG,39,27,66,1.309216737397363,Hawkish
고발/NNG,29,11,40,2.3895494297951876,Hawkish
적체/NNG,36,10,46,3.262970945513428,Hawkish
노동자/NNG,135,68,203,1.7994325067169639,Hawkish
역마진/NNG,62,41,103,1.3706246519094345,Hawkish
신용/NNG;개선/NNG,19,11,30,1.5655668677968468,Hawkish
이표/NNG,385,268,653,1.302076921665288,Hawkish
어긋나/VV,26,15,41,1.5710600848768357,Hawkish
근로시간/NNG,98,54,152,1.6449133367300204,Hawkish
불균형/NNG;완화/NNG,40,23,63,1.5763144664316078,Hawkish
다우/VV,16,5,21,2.9004186182341583,Hawkish
대손충당금/NNG,194,103,297,1.7071638711693773,Hawkish
수출/NNG;경기/NNG;부진/NNG,19,6,25,2.870205924294219,Hawkish
미지근/NNG,14,7,21,1.812761636396349,Hawkish
ecb/NNG;통화/NNG;긴축/NNG,13,7,20,1.6832786623680382,Hawkish
바라봤/VV,22,9,31,2.2155975555955374,Hawkish
소비자/NNG;물가/NNG;예상/NNG;높/VA,24,9,33,2.417015515195132,Hawkish
양키본드/NNG,19,2,21,8.610617772882657,Hawkish
채국/NNG,18,10,28,1.631485472756714,Hawkish
맹점/NNG,33,19,52,1.574240368449461,Hawkish
윤창/NNG,173,60,233,2.6133980258047362,Hawkish
소비자/NNG;물가/NNG;완화/NNG,26,7,33,3.3665573247360765,Hawkish
판매/NNG;부진/NNG,18,9,27,1.812761636396349,Hawkish
들어서야/VV,14,4,18,3.1723328636936103,Hawkish
롱스탑/NNG,24,12,36,1.8127616363963488,Hawkish
아세안+3/NNG,20,2,22,9.063808181981745,Hawkish
어도/NNG,13,7,20,1.6832786623680382,Hawkish
상상화/NNG,17,10,27,1.5408473909368965,Hawkish
가격/NNG;소폭/MAG;하락/NNG,14,7,21,1.812761636396349,Hawkish
국채/NNG;발행/NNG;성공/NNG,11,7,18,1.424312714311417,Hawkish
소비/NNG;둔화/NNG;우려/NNG,13,8,21,1.4728688295720334,Hawkish
부동산/NNG;경기/NNG;악화/NNG,15,9,24,1.5106346969969573,Hawkish
경기/NNG;둔화/NNG;우려/NNG;확대/NNG,15,9,24,1.5106346969969573,Hawkish
낮/VA;성장/NNG,27,8,35,3.0590352614188387,Hawkish
부정적/VAX;하향/NNG,16,11,27,1.3183720991973447,Hawkish
강수량/NNG,31,9,40,3.121978373793712,Hawkish
시범/NNG,47,31,78,1.374190272752071,Hawkish
탐욕/NNG,21,6,27,3.1723328636936103,Hawkish
무착륙/NNG,12,8,20,1.3595712272972615,Hawkish
금리/NNG;회복/NNG,11,6,17,1.661698166696653,Hawkish
회사채/NNG;금리/NNG;하락/NNG,11,6,17,1.661698166696653,Hawkish
자금사정/NNG,86,51,137,1.528406869902804,Hawkish
전망/NNG;위험/NNG,48,27,75,1.6113436767967546,Hawkish
훈련/NNG,70,39,109,1.6268373659967232,Hawkish
국고채/NNG;금리/NNG;인하/NNG,32,17,49,1.7061285989612696,Hawkish
광역/NNG,25,13,38,1.7430400349964892,Hawkish
강달러/NNG,312,150,462,1.885272101852203,Hawkish
입찰자/NNG,27,8,35,3.0590352614188387,Hawkish
과도/NNG;긴축/NNG,25,12,37,1.8882933712461967,Hawkish
중고차/NNG,132,52,184,2.300812846195366,Hawkish
은행업계/NNG,11,6,17,1.661698166696653,Hawkish
스쿨/NNG,13,5,18,2.3565901273152536,Hawkish
가져/VV,33,21,54,1.424312714311417,Hawkish
순운전자본/NNG,21,2,23,9.516998591080831,Hawkish
평판/NNG,19,12,31,1.4351029621471094,Hawkish
폐쇄/NNG;우려/NNG,15,8,23,1.699464034121577,Hawkish
정치/NNG;위험/NNG;확대/NNG,12,8,20,1.3595712272972615,Hawkish
건설현장/NNG,21,12,33,1.5861664318468052,Hawkish
자분/NNG,19,6,25,2.870205924294219,Hawkish
중기채/NNG,29,14,43,1.8775031234105044,Hawkish
전속/NNG,18,4,22,4.078713681891785,Hawkish
투기거래/NNG,15,2,17,6.797856136486308,Hawkish
환율효과/NNG,26,10,36,2.3565901273152536,Hawkish
주어진/VV,38,22,60,1.5655668677968468,Hawkish
세계화/NNG,81,44,125,1.6685646880466394,Hawkish
인플레이션/NNG;기대/NNG;확산/NNG,14,7,21,1.812761636396349,Hawkish
원화/NNG;하락/NNG,28,9,37,2.819851434394321,Hawkish
상환자금/NNG,31,20,51,1.4048902682071702,Hawkish
대체자산/NNG,24,6,30,3.6255232727926976,Hawkish
차종/NNG,17,10,27,1.5408473909368965,Hawkish
행량/NNG,24,8,32,2.719142454594523,Hawkish
eb/NNG,133,61,194,1.976207357710774,Hawkish
정국/NNG,36,20,56,1.631485472756714,Hawkish
동조성/NNG,31,14,45,2.0069860974388147,Hawkish
경제/NNG;전망/NNG;성장률/NNG;전망/NNG;하향/NNG,14,5,19,2.5378662909548884,Hawkish
미소금융/NNG,18,4,22,4.078713681891785,Hawkish
용도지역/NNG,13,4,17,2.9457376591440667,Hawkish
미/NNG;경기/NNG;침체/NNG,13,7,20,1.6832786623680382,Hawkish
이차보전/NNG,13,5,18,2.3565901273152536,Hawkish
다세대주택/NNG,17,6,23,2.5680789848948273,Hawkish
신용위험/NNG;우려/NNG,15,9,24,1.5106346969969573,Hawkish
약하/VA;우려/NNG,15,2,17,6.797856136486308,Hawkish
종사자수/NNG,30,3,33,9.063808181981743,Hawkish
순응/NNG,23,16,39,1.3029224261598757,Hawkish
인플레이션/NNG;기대/NNG;하락/NNG,12,5,17,2.1753139636756185,Hawkish
공감/NNG,104,72,176,1.309216737397363,Hawkish
측은/NNG,22,11,33,1.8127616363963488,Hawkish
수출/NNG;둔화/NNG,50,29,79,1.5627255486175422,Hawkish
발주/NNG,64,34,98,1.7061285989612696,Hawkish
전망/NNG;긴축/NNG,22,10,32,1.9940378000359835,Hawkish
배상비/NNG,22,11,33,1.8127616363963488,Hawkish
경기/NNG;불확실성/NNG;증가/NNG,18,5,23,3.262970945513428,Hawkish
도도/NNG,534,341,875,1.419376413248754,Hawkish
침체/NNG,2820,1910,4730,1.3382167054025402,Hawkish
조금/NNG,58,38,96,1.3834233540919505,Hawkish
금리/NNG;인하/NNG;기대/NNG;후퇴/NNG,113,77,190,1.3301432786544638,Hawkish
괴리율/NNG,24,12,36,1.8127616363963488,Hawkish
노드/NNG,13,5,18,2.3565901273152536,Hawkish
하상/MAG,24,14,38,1.5537956883397277,Hawkish
입주/NNG,212,93,305,2.0661584242797097,Hawkish
견디/VV,62,43,105,1.3068746680996934,Hawkish
실적결과/NNG,12,6,18,1.8127616363963488,Hawkish
대대감/NNG,12,5,17,2.1753139636756185,Hawkish
매크로/NNG;불확실성/NNG,19,12,31,1.4351029621471094,Hawkish
활성/NNG,31,21,52,1.3379907316258763,Hawkish
회안/NNG,14,8,22,1.5861664318468052,Hawkish
자본시장법/NNG,34,13,47,2.370534447595225,Hawkish
이메일/NNG,181,75,256,2.1873990412515942,Hawkish
희귀/NNG,13,7,20,1.6832786623680382,Hawkish
박자/NNG,11,7,18,1.424312714311417,Hawkish
주최/NNG,102,51,153,1.8127616363963488,Hawkish
확전/NNG,216,116,332,1.6877435925069455,Hawkish
시리즈/NNG,70,40,110,1.5861664318468052,Hawkish
갈갈갈갈/MAG,13,6,19,1.9638251060960445,Hawkish
국채/NNG;가격/NNG;하락/NNG,32,16,48,1.8127616363963488,Hawkish
비용/NNG;하락/NNG,11,7,18,1.424312714311417,Hawkish
예탁/NNG,72,38,110,1.7173531292175939,Hawkish
방어선/NNG,13,5,18,2.3565901273152536,Hawkish
분배금/NNG,75,49,124,1.387317578874757,Hawkish
전략/NNG,5562,3581,9143,1.4077883582290551,Hawkish
단호/NNG,60,26,86,2.091648041995787,Hawkish
겨울철/NNG,31,12,43,2.3414837803452837,Hawkish
트윗/NNG,12,7,19,1.5537956883397277,Hawkish
킬킬/MAG,11,6,17,1.661698166696653,Hawkish
담겼/VV,35,20,55,1.5861664318468052,Hawkish
사령관/NNG,23,9,32,2.3163065353953347,Hawkish
숫자/NNG,273,190,463,1.3023261229900085,Hawkish
재할인/NNG,97,63,160,1.3955387200829035,Hawkish
기술적/VAX;침체/NNG,11,7,18,1.424312714311417,Hawkish
넥스트/NNG,35,7,42,4.5319040909908725,Hawkish
당선인/NNG,67,34,101,1.786103377037579,Hawkish
총총/MAG,311,196,507,1.4381858901001645,Hawkish
내셔널/VAX,18,12,30,1.3595712272972618,Hawkish
우려/NNG;fed/NNG;긴축/NNG,22,4,26,4.985094500089959,Hawkish
구성비중/NNG,33,13,46,2.300812846195366,Hawkish
기모/NNG,26,16,42,1.4728688295720334,Hawkish
인하/NNG;없/VA,28,17,45,1.4928625240911106,Hawkish
몸집/NNG,16,9,25,1.6113436767967546,Hawkish
투자금융/NNG,67,39,106,1.5571157645968636,Hawkish
기각/NNG,23,14,37,1.4890542013255725,Hawkish
낙찰가율/NNG,16,11,27,1.3183720991973447,Hawkish
순우/NNG,103,24,127,3.8898843447671654,Hawkish
최선/NNG,129,80,209,1.4615390693445562,Hawkish
자이/NNG,17,7,24,2.201210558481281,Hawkish
고용/NNG;감소/NNG,31,15,46,1.8731870242762272,Hawkish
승인액/NNG,23,6,29,3.474459803093002,Hawkish
주택사업/NNG,70,23,93,2.7585503162553136,Hawkish
단체/NNG,128,86,214,1.3490319154577481,Hawkish
적자/NNG;확대/NNG,27,10,37,2.447228209135071,Hawkish
헬스/NNG,139,90,229,1.3998548192171805,Hawkish
정착/NNG,69,45,114,1.389783921237201,Hawkish
일정금액/NNG,13,4,17,2.9457376591440667,Hawkish
내규/NNG,19,2,21,8.610617772882657,Hawkish
픽업/NNG,78,15,93,4.713180254630507,Hawkish
예상/NNG;양호/NNG,58,40,98,1.314252186387353,Hawkish
벌금/NNG,56,22,78,2.3071511735953534,Hawkish
순자산/NNG,374,233,607,1.4548773648331212,Hawkish
급히/MAG,19,5,24,3.444247109153063,Hawkish
팽창/NNG,79,44,123,1.6273655599467223,Hawkish
재무/NNG;건전성/NNG;개선/NNG,15,10,25,1.3595712272972615,Hawkish
고정비/NNG,58,33,91,1.5930329531967917,Hawkish
락하/NNG,47,31,78,1.374190272752071,Hawkish
마이/MAG,34,9,43,3.4241053131931034,Hawkish
배달/NNG,33,13,46,2.300812846195366,Hawkish
확인서/NNG,13,5,18,2.3565901273152536,Hawkish
의임/NNG,25,9,34,2.5177244949949293,Hawkish
인사말/NNG,14,8,22,1.5861664318468052,Hawkish
내줬/VV,29,16,45,1.6428152329841912,Hawkish
수익성/NNG;부담/NNG,15,5,20,2.719142454594523,Hawkish
에너지제외지수/NNG,154,80,234,1.7447830750314859,Hawkish
해년/NNG,66,35,101,1.7091752571737004,Hawkish
예상/NNG;낮/VA,50,31,81,1.4619045454809265,Hawkish
강하/VA;성장/NNG,25,17,42,1.332912967938492,Hawkish
통령/NNG,14,5,19,2.5378662909548884,Hawkish
떨떨/MAG,15,5,20,2.719142454594523,Hawkish
예상/NNG;인상/NNG,20,12,32,1.5106346969969575,Hawkish
계정/NNG,634,339,973,1.6951192883116302,Hawkish
가수급/NNG,38,22,60,1.5655668677968468,Hawkish
지원책/NNG,136,68,204,1.8127616363963486,Hawkish
매출/NNG;오르/VV,16,6,22,2.417015515195132,Hawkish
파일/NNG,20,13,33,1.3944320279971913,Hawkish
경로/NNG,2899,1989,4888,1.3210648526679276,Hawkish
가게/NNG,13,9,22,1.309216737397363,Hawkish
특판/NNG,41,18,59,2.0645340858958416,Hawkish
달달달/MAG,126,70,196,1.631485472756714,Hawkish
계신/NNG,47,31,78,1.374190272752071,Hawkish
인플레이션/NNG;긴축/NNG,14,7,21,1.812761636396349,Hawkish
업황/NNG;둔화/NNG,32,15,47,1.9336124121561056,Hawkish
성질/NNG,31,13,44,2.1613696433956466,Hawkish
격상/NNG,38,20,58,1.7221235545765314,Hawkish
성장/NNG;정체/NNG,12,5,17,2.1753139636756185,Hawkish
소년/NNG,13,4,17,2.9457376591440667,Hawkish
채수/NNG,316,148,464,1.9352455307474534,Hawkish
꼼꼼히/MAG,11,6,17,1.661698166696653,Hawkish
지하층/NNG,21,9,30,2.1148885757957405,Hawkish
실적/NNG;상승/NNG,28,12,40,2.1148885757957405,Hawkish
위험/NNG;축소/NNG,31,14,45,2.0069860974388147,Hawkish
반환점/NNG,183,2,185,82.93384486513297,Hawkish
지정학/NNG;위험/NNG;증대/NNG,20,13,33,1.3944320279971913,Hawkish
많/VA;불확실성/NNG,16,11,27,1.3183720991973447,Hawkish
이웃/NNG,15,8,23,1.699464034121577,Hawkish
위탁매매/NNG,26,15,41,1.5710600848768357,Hawkish
저임금/NNG,11,7,18,1.424312714311417,Hawkish
gdp/NNG;호조/NNG,21,14,35,1.3595712272972618,Hawkish
코넥스/NNG,23,7,30,2.978108402651145,Hawkish
기우/NNG,43,16,59,2.4358984489075937,Hawkish
보유현금/NNG,79,51,130,1.404001659561878,Hawkish
다각화/NNG,173,116,289,1.351757599554174,Hawkish
채미/NNG,16,5,21,2.9004186182341583,Hawkish
베타/NNG,21,11,32,1.7303633801965148,Hawkish
가점/NNG,16,8,24,1.8127616363963488,Hawkish
악몽/NNG,23,10,33,2.084675881855801,Hawkish
최단/NNG,14,3,17,4.229777151591481,Hawkish
양해/NNG,15,5,20,2.719142454594523,Hawkish
국민연금/NNG,276,189,465,1.3236037345116198,Hawkish
기대/NNG;지연/NNG,22,13,35,1.5338752307969103,Hawkish
어감/NNG,144,71,215,1.8382934904301005,Hawkish
기간프리미엄/NNG;축소/NNG,13,5,18,2.3565901273152536,Hawkish
자금/NNG;조달/NNG;비용/NNG;상승/NNG,11,6,17,1.661698166696653,Hawkish
일축/NNG,164,88,252,1.689164252096598,Hawkish
운용팀/NNG,12,8,20,1.3595712272972615,Hawkish
보복/NNG,528,253,781,1.8915773597179295,Hawkish
냉전/NNG,13,8,21,1.4728688295720334,Hawkish
한미/NNG,828,481,1309,1.560256377272533,Hawkish
탈동조화/NNG,113,35,148,2.9263152130398202,Hawkish
회전신용/NNG,12,7,19,1.5537956883397277,Hawkish
무부/NNG,13,7,20,1.6832786623680382,Hawkish
판매비율/NNG,14,9,23,1.4099257171971604,Hawkish
주택자금/NNG,37,21,58,1.5969566796824977,Hawkish
성급/NNG,68,41,109,1.5032657472555089,Hawkish
유가/NNG;상승/NNG;압력/NNG,16,10,26,1.4502093091170791,Hawkish
예상/NNG;좋/VA,23,11,34,1.895159892596183,Hawkish
목표물/NNG,22,10,32,1.9940378000359835,Hawkish
경제/NNG;양호/NNG;성장/NNG,19,8,27,2.1526544432206642,Hawkish
하락/NNG;높/VA,13,7,20,1.6832786623680382,Hawkish
재량/NNG,61,42,103,1.3164102359544914,Hawkish
의사/NNG,328,212,540,1.4023250394764206,Hawkish
지표/NNG;견조/NNG,27,14,41,1.7480201493821939,Hawkish
성장/NNG;확대/NNG,22,11,33,1.8127616363963488,Hawkish
보완자본/NNG,46,26,72,1.6035968321967702,Hawkish
종합지원/NNG,20,9,29,2.0141795959959437,Hawkish
치적/NNG,14,3,17,4.229777151591481,Hawkish
사견/NNG,13,8,21,1.4728688295720334,Hawkish
후년/NNG,21,5,26,3.8067994364323328,Hawkish
높/VA;완화/NNG,12,8,20,1.3595712272972615,Hawkish
부흥/NNG,16,10,26,1.4502093091170791,Hawkish
산업별/NNG,28,13,41,1.9522048391960678,Hawkish
모델/NNG,396,269,665,1.3343003866411787,Hawkish
배리/NNG,13,6,19,1.9638251060960445,Hawkish
외평기금/NNG,57,6,63,8.610617772882657,Hawkish
자금부족/NNG,30,12,42,2.265952045495436,Hawkish
위험/NNG;회피/NNG;완화/NNG,34,10,44,3.081694781873793,Hawkish
연구진/NNG,11,6,17,1.661698166696653,Hawkish
스테이트/NNG,19,3,22,5.740411848588438,Hawkish
내수/NNG;경기/NNG;회복/NNG,11,6,17,1.661698166696653,Hawkish
도지/NNG,17,10,27,1.5408473909368965,Hawkish
비동조화/NNG,37,9,46,3.726232252592495,Hawkish
기지개/NNG,19,13,32,1.3247104265973317,Hawkish
하늘색/NNG,14,5,19,2.5378662909548884,Hawkish
지남/VV,66,39,105,1.5338752307969106,Hawkish
국고채/NNG;통안채/NNG;스프레드/NNG;확대/NNG,58,12,70,4.380840621291177,Hawkish
추적/NNG,73,48,121,1.3784541610097236,Hawkish
강력매수/NNG,159,99,258,1.455702526197068,Hawkish
따뜻/NNG,36,18,54,1.812761636396349,Hawkish
적립/NNG,336,228,564,1.3357191005025728,Hawkish
금리/NNG;우려/NNG,24,15,39,1.4502093091170791,Hawkish
기대/NNG;웃돌/VV,15,4,19,3.398928068243154,Hawkish
김치/NNG,11,7,18,1.424312714311417,Hawkish
재무관리/NNG,33,17,50,1.7594451176788093,Hawkish
대출/NNG;금리/NNG;인하/NNG,33,22,55,1.3595712272972618,Hawkish
채권시장/NNG;높/VA,11,6,17,1.661698166696653,Hawkish
무상/NNG,50,32,82,1.4162200284346476,Hawkish
커버드콜/NNG,81,53,134,1.3852235146047571,Hawkish
수익성/NNG;하락/NNG,34,21,55,1.467473705654187,Hawkish
포효/NNG,16,1,17,14.50209309117079,Hawkish
졸업/NNG,42,26,68,1.464153629397051,Hawkish
어질/VA,167,113,280,1.3395185543282755,Hawkish
회보/NNG,13,4,17,2.9457376591440667,Hawkish
귀환/NNG,30,10,40,2.719142454594523,Hawkish
용품/NNG,73,37,110,1.788264857526128,Hawkish
하락/NNG;부정적/VAX,16,11,27,1.3183720991973447,Hawkish
인플레이션/NNG;위험/NNG,97,53,150,1.658847912551376,Hawkish
대출/NNG;수요/NNG;감소/NNG,15,10,25,1.3595712272972615,Hawkish
마법/NNG,15,5,20,2.719142454594523,Hawkish
디비/NNG,125,60,185,1.8882933712461967,Hawkish
등금/NNG,19,8,27,2.1526544432206642,Hawkish
물가/NNG;긍정적/VAX,15,10,25,1.3595712272972615,Hawkish
거래제/NNG,33,4,37,7.477641750134939,Hawkish
유산/NNG,15,8,23,1.699464034121577,Hawkish
산연/NNG,30,8,38,3.398928068243154,Hawkish
중대재해/NNG,14,6,20,2.1148885757957405,Hawkish
금리/NNG;인상/NNG;가속/NNG,14,3,17,4.229777151591481,Hawkish
전단채/NNG,159,80,239,1.8014318761688715,Hawkish
위험/NNG;금리/NNG;인상/NNG,34,17,51,1.8127616363963486,Hawkish
금리/NNG;인상/NNG;제약/NNG,13,5,18,2.3565901273152536,Hawkish
교역조건/NNG,85,52,137,1.4815840297470158,Hawkish
통화/NNG;길/VA,18,6,24,2.7191424545945235,Hawkish
열심히/MAG,33,11,44,2.7191424545945235,Hawkish
아이러니/NNG,20,11,31,1.647965123996681,Hawkish
위험/NNG;많/VA,13,6,19,1.9638251060960445,Hawkish
시장지배력/NNG,32,20,52,1.4502093091170791,Hawkish
전세보증금반환보증/NNG,14,5,19,2.5378662909548884,Hawkish
갈리/VV,33,18,51,1.6616981666966535,Hawkish
위험/NNG;금리/NNG;인하/NNG,11,7,18,1.424312714311417,Hawkish
물가/NNG;상승률/NNG;상향/NNG,26,8,34,2.9457376591440667,Hawkish
한국물/NNG,145,90,235,1.4602802070970589,Hawkish
학대/NNG,16,7,23,2.0717275844529706,Hawkish
준공후미분양/NNG,87,9,96,8.761681242582354,Hawkish
시오스/NNG,19,6,25,2.870205924294219,Hawkish
가격/NNG;둔화/NNG,13,8,21,1.4728688295720334,Hawkish
글로벌/NNG;채권시장/NNG;강세/NNG,11,7,18,1.424312714311417,Hawkish
그림자/NNG,39,27,66,1.309216737397363,Hawkish
모면/NNG,21,11,32,1.7303633801965148,Hawkish
번주/NNG,27,18,45,1.3595712272972618,Hawkish
드릴/VV,50,32,82,1.4162200284346476,Hawkish
걸린다/VV,16,8,24,1.8127616363963488,Hawkish
상승률/NNG;낮/VA,45,22,67,1.853960764496266,Hawkish
금리/NNG;상승/NNG;하락/NNG,33,23,56,1.3004594348060765,Hawkish
물가/NNG;지표/NNG;우려/NNG,20,3,23,6.04253878798783,Hawkish
경유/NNG,51,25,76,1.8490168691242757,Hawkish
취합/NNG,42,27,69,1.4099257171971602,Hawkish
축제/NNG,20,8,28,2.2659520454954363,Hawkish
기대/NNG;되돌/VV,19,10,29,1.7221235545765314,Hawkish
fed/NNG;금리/NNG;인하/NNG;기대/NNG;약화/NNG,37,23,60,1.458090881449237,Hawkish
노인/NNG,49,32,81,1.3878956278659547,Hawkish
화재/NNG,45,28,73,1.4566834578184946,Hawkish
금리/NNG;인상/NNG;가능성/NNG;차단/NNG,17,1,18,15.408473909368965,Hawkish
임금지표/NNG,29,20,49,1.314252186387353,Hawkish
물가/NNG;전망/NNG;불확실성/NNG,37,11,48,3.0487354793938595,Hawkish
고용시장/NNG;견조/NNG,43,26,69,1.4990144300969808,Hawkish
무섭/VA,23,15,38,1.389783921237201,Hawkish
채권시장/NNG;fed/NNG;매파/NNG,12,8,20,1.3595712272972615,Hawkish
경기/NNG;불확실성/NNG;확대/NNG,16,8,24,1.8127616363963488,Hawkish
참패/NNG,44,13,57,3.0677504615938207,Hawkish
고용/NNG;고용자수/NNG;증가/NNG,28,16,44,1.5861664318468052,Hawkish
높/VA;매파/NNG,12,5,17,2.1753139636756185,Hawkish
물가/NNG;상승률/NNG;전망/NNG;상향/NNG,23,11,34,1.895159892596183,Hawkish
카드론/NNG,144,77,221,1.6950498418251576,Hawkish
오일쇼크/NNG,74,27,101,2.484154835061663,Hawkish
통국/NNG,81,26,107,2.8237248566943123,Hawkish
투자심리/NNG;냉각/NNG,17,7,24,2.201210558481281,Hawkish
핀셋/NNG,18,7,25,2.3306935325095917,Hawkish
검은색/NNG,17,8,25,1.9260592386711206,Hawkish
초장/NNG,12,6,18,1.8127616363963488,Hawkish
퀄컴/NNG,49,20,69,2.2206330045855274,Hawkish
주리/NNG,175,65,240,2.440256048995085,Hawkish
부지/NNG,105,59,164,1.613050608657768,Hawkish
비미국/NNG,60,27,87,2.014179595995943,Hawkish
오랜만/NNG,39,24,63,1.4728688295720336,Hawkish
외감/NNG,27,12,39,2.0393568409458926,Hawkish
멀티플/NNG,26,9,35,2.618433474794726,Hawkish
상승률/NNG,6965,4667,11632,1.3526767513928188,Hawkish
실적시즌/NNG,92,58,150,1.4377075047281387,Hawkish
비용/NNG;낮/VV,18,12,30,1.3595712272972618,Hawkish
세부섹터/NNG,20,13,33,1.3944320279971913,Hawkish
메이저/NNG,28,18,46,1.4099257171971604,Hawkish
대손비용/NNG,169,92,261,1.6649821551683857,Hawkish
즉시/NNG,14,6,20,2.1148885757957405,Hawkish
부동산투자회사/NNG,15,9,24,1.5106346969969573,Hawkish
야당/NNG,183,112,295,1.4809615154488032,Hawkish
통방/NNG,68,24,92,2.5680789848948273,Hawkish
통화정책방향결정회의/NNG,106,37,143,2.5966585602434185,Hawkish
연신/MAG,18,2,20,8.15742736378357,Hawkish
상환금액/NNG,21,9,30,2.1148885757957405,Hawkish
다다다다/MAG,212,115,327,1.670893334417504,Hawkish
금리/NNG;추세/NNG;하락/NNG,20,8,28,2.2659520454954363,Hawkish
디커플링/NNG,137,85,222,1.460872612860587,Hawkish
버텨/VV,33,15,48,1.994037800035984,Hawkish
전기요금/NNG;인상/NNG,42,27,69,1.4099257171971602,Hawkish
인상/NNG;종료/NNG,38,23,61,1.4974987431100273,Hawkish
금현/NNG,17,9,26,1.7120526565965517,Hawkish
함함/NNG,39,20,59,1.7674425954864401,Hawkish
콜조항/NNG,21,5,26,3.8067994364323328,Hawkish
인상/NNG;제한/NNG,13,7,20,1.6832786623680382,Hawkish
곳간/NNG,16,7,23,2.0717275844529706,Hawkish
대지진/NNG,16,11,27,1.3183720991973447,Hawkish
싸늘/NNG,19,9,28,1.9134706161961461,Hawkish
북한리스크/NNG,98,56,154,1.5861664318468054,Hawkish
분양가/NNG,170,40,210,3.852118477342241,Hawkish
권투/NNG,20,7,27,2.589659480566213,Hawkish
점점점/MAG,78,30,108,2.3565901273152536,Hawkish
코끼리/NNG,16,7,23,2.0717275844529706,Hawkish
숙련/NNG,30,15,45,1.8127616363963488,Hawkish
양대/NNG,19,12,31,1.4351029621471094,Hawkish
다가선/VV,18,12,30,1.3595712272972618,Hawkish
르네상스/NNG,18,5,23,3.262970945513428,Hawkish
재정/NNG;건전성/NNG;우려/NNG,11,7,18,1.424312714311417,Hawkish
농산/NNG,26,17,43,1.3862294866560314,Hawkish
자생력/NNG,60,34,94,1.5994955615261899,Hawkish
갈수록/MAG,447,306,753,1.3240268814855685,Hawkish
단기/NNG;위험/NNG,17,6,23,2.5680789848948273,Hawkish
유가/NNG;높/VA,11,7,18,1.424312714311417,Hawkish
제품군/NNG,17,6,23,2.5680789848948273,Hawkish
적립비율/NNG,16,5,21,2.9004186182341583,Hawkish
데데/NNG,65,22,87,2.6779433264946064,Hawkish
가격/NNG;부담/NNG;인식/NNG;높/VA,16,1,17,14.50209309117079,Hawkish
저저/NNG,43,13,56,2.9980288601939615,Hawkish
기후변화/NNG,298,135,433,2.000751732022637,Hawkish
되레/MAG,16,10,26,1.4502093091170791,Hawkish
gdp/NNG;높/VA,13,9,22,1.309216737397363,Hawkish
손해액/NNG,13,4,17,2.9457376591440667,Hawkish
인하/NNG;전환/NNG,51,28,79,1.6509079188609606,Hawkish
긴축/NNG;부작용/NNG,13,4,17,2.9457376591440667,Hawkish
확실히/MAG,199,124,323,1.4545950227535218,Hawkish
fed/NNG;금리/NNG;인상/NNG;중단/NNG,13,8,21,1.4728688295720334,Hawkish
가뜩이나/MAG,31,17,48,1.6528120802437296,Hawkish
기업집단/NNG,17,9,26,1.7120526565965517,Hawkish
시장지위/NNG,160,106,266,1.3681219897330936,Hawkish
비상장/NNG,93,37,130,2.2782004349305462,Hawkish
약관/NNG,20,13,33,1.3944320279971913,Hawkish
투자자산/NNG,123,85,208,1.311586360451476,Hawkish
시장조성자/NNG,16,7,23,2.0717275844529706,Hawkish
구실/NNG,14,6,20,2.1148885757957405,Hawkish
할할/MAG,219,142,361,1.3978690083478889,Hawkish
금리/NNG;인상/NNG;속도/NNG;늦/VV,19,9,28,1.9134706161961461,Hawkish
소기업낙관지수/NNG,60,32,92,1.699464034121577,Hawkish
물가/NNG;상승/NNG;우려/NNG,50,28,78,1.618537175353883,Hawkish
플레이션/NNG,88,41,129,1.9454027317424232,Hawkish
집세/NNG,51,32,83,1.4445444290033405,Hawkish
추경/NNG;우려/NNG,14,9,23,1.4099257171971604,Hawkish
구직자/NNG,38,18,56,1.9134706161961461,Hawkish
놓칠/VV,16,7,23,2.0717275844529706,Hawkish
난이도/NNG,50,33,83,1.3733042699972342,Hawkish
회금/NNG,17,8,25,1.9260592386711206,Hawkish
학사/NNG,17,10,27,1.5408473909368965,Hawkish
장금/NNG,59,14,73,3.819747733835164,Hawkish
단추/NNG,21,11,32,1.7303633801965148,Hawkish
일정비율/NNG,14,8,22,1.5861664318468052,Hawkish
주축/NNG,28,17,45,1.4928625240911106,Hawkish
매소/NNG,27,11,38,2.224752917395519,Hawkish
탄소시장/NNG,16,1,17,14.50209309117079,Hawkish
사업자보증/NNG,22,7,29,2.848625428622834,Hawkish
명목채/NNG,42,22,64,1.7303633801965148,Hawkish
수입국/NNG,38,24,62,1.4351029621471094,Hawkish
지킬/VV,11,7,18,1.424312714311417,Hawkish
원화/NNG;절상/NNG,38,23,61,1.4974987431100273,Hawkish
베일인/NNG,63,16,79,3.5688744716553122,Hawkish
계대/NNG,19,12,31,1.4351029621471094,Hawkish
외래/NNG,21,7,28,2.7191424545945235,Hawkish
생활형편/NNG,24,16,40,1.3595712272972615,Hawkish
우발채무/NNG;부담/NNG,11,6,17,1.661698166696653,Hawkish
금리/NNG;인하/NNG;통화정책/NNG;완화/NNG,22,5,27,3.988075600071967,Hawkish
점선/NNG,122,74,196,1.4943035110834768,Hawkish
차입/NNG;부담/NNG;완화/NNG,18,6,24,2.7191424545945235,Hawkish
공공요금/NNG,255,176,431,1.313222208184855,Hawkish
난다/VV,20,8,28,2.2659520454954363,Hawkish
완수/NNG,14,8,22,1.5861664318468052,Hawkish
비빌/VV,13,7,20,1.6832786623680382,Hawkish
민간/NNG;소비/NNG;개선/NNG,25,10,35,2.2659520454954363,Hawkish
내려간다는/VV,13,5,18,2.3565901273152536,Hawkish
글로벌/NNG;금리/NNG;인상/NNG,19,12,31,1.4351029621471094,Hawkish
경기/NNG;위험/NNG,18,5,23,3.262970945513428,Hawkish
채무보증/NNG,47,31,78,1.374190272752071,Hawkish
담화/NNG,27,10,37,2.447228209135071,Hawkish
망대/NNG,12,5,17,2.1753139636756185,Hawkish
견이/NNG,31,15,46,1.8731870242762272,Hawkish
계열화/NNG,15,7,22,1.9422446104246596,Hawkish
국고채/NNG;금리/NNG;하단/NNG,13,8,21,1.4728688295720334,Hawkish
진보/NNG,32,13,45,2.2310912447955062,Hawkish
매입비중/NNG,41,18,59,2.0645340858958416,Hawkish
이해관계/NNG,391,268,659,1.3223690295353963,Hawkish
자유무역협정/NNG,15,9,24,1.5106346969969573,Hawkish
유출액/NNG,13,9,22,1.309216737397363,Hawkish
pmi/NNG;하락/NNG,11,6,17,1.661698166696653,Hawkish
적립액/NNG,39,11,50,3.213531991793528,Hawkish
공과/NNG,19,7,26,2.460176506537902,Hawkish
물가/NNG;하회/NNG,15,9,24,1.5106346969969573,Hawkish
경제활동참가율/NNG,216,123,339,1.5916931441528919,Hawkish
납품/NNG,54,26,80,1.8824832377962084,Hawkish
산불/NNG,29,4,33,6.571260931936765,Hawkish
부동산/NNG;거품/NNG,17,11,28,1.4007703553971786,Hawkish
투자분석/NNG,68,20,88,3.081694781873793,Hawkish
히스패닉/NNG,11,7,18,1.424312714311417,Hawkish
크레딧/NNG;금리/NNG;상승/NNG,13,9,22,1.309216737397363,Hawkish
고조/NNG,597,406,1003,1.332781646463818,Hawkish
고용자수/NNG,1101,755,1856,1.321755338855881,Hawkish
투자/NNG;지연/NNG,13,4,17,2.9457376591440667,Hawkish
종사자/NNG,44,16,60,2.4925472500449795,Hawkish
소비자/NNG;물가/NNG;둔화/NNG,50,19,69,2.3852126794688804,Hawkish
수수께끼/NNG,35,22,57,1.4419694834970957,Hawkish
체전/NNG,14,6,20,2.1148885757957405,Hawkish
유지율/NNG,14,6,20,2.1148885757957405,Hawkish
나눠/VV,78,48,126,1.4728688295720336,Hawkish
출장/NNG,36,24,60,1.3595712272972618,Hawkish
돌아올/VV,88,41,129,1.9454027317424232,Hawkish
우려/NNG;낮/VA,41,21,62,1.7696006450535784,Hawkish
긴장/NNG;완화/NNG,34,18,52,1.7120526565965517,Hawkish
경제동향/NNG,89,41,130,1.967509580966769,Hawkish
놀란/VV,19,13,32,1.3247104265973317,Hawkish
압류/NNG,50,24,74,1.8882933712461967,Hawkish
너비/NNG,164,66,230,2.2522190027954636,Hawkish
멤버십/NNG,18,7,25,2.3306935325095917,Hawkish
반기보고서/NNG,17,11,28,1.4007703553971786,Hawkish
완제품/NNG,11,6,17,1.661698166696653,Hawkish
임대/NNG,260,177,437,1.3314068515905386,Hawkish
고점/NNG;하락/NNG,24,9,33,2.417015515195132,Hawkish
신용스프레드/NNG;안정/NNG,30,18,48,1.5106346969969573,Hawkish
단일시장/NNG,25,7,32,3.237074350707766,Hawkish
몰아주/VV,27,9,36,2.7191424545945235,Hawkish
물가/NNG;하향/NNG;안정/NNG,15,7,22,1.9422446104246596,Hawkish
화폐발행액/NNG,18,4,22,4.078713681891785,Hawkish
공사현장/NNG,15,3,18,4.531904090990872,Hawkish
부활절/NNG,44,20,64,1.9940378000359835,Hawkish
합산비율/NNG,27,5,32,4.894456418270142,Hawkish
서술/NNG,18,5,23,3.262970945513428,Hawkish
교육비/NNG,21,8,29,2.379249647770208,Hawkish
가계/NNG;신용/NNG;증가/NNG,11,7,18,1.424312714311417,Hawkish
금리/NNG;인하/NNG;압박/NNG,16,9,25,1.6113436767967546,Hawkish
기한/NNG,127,78,205,1.4757738962970277,Hawkish
금융시장/NNG;위축/NNG,22,6,28,3.323396333393306,Hawkish
꺼려/VV,14,6,20,2.1148885757957405,Hawkish
원자재/NNG;가격/NNG;상승/NNG,89,60,149,1.344464880327292,Hawkish
선발행/NNG,47,20,67,2.12999492276571,Hawkish
관할/NNG,41,18,59,2.0645340858958416,Hawkish
재건축/NNG,126,76,202,1.5026839880653946,Hawkish
생긴다/VV,31,17,48,1.6528120802437296,Hawkish
고민거리/NNG,19,13,32,1.3247104265973317,Hawkish
전열/NNG,40,2,42,18.12761636396349,Hawkish
금리/NNG;인하/NNG;늦/VA,44,24,68,1.661698166696653,Hawkish
액티브펀드/NNG,13,8,21,1.4728688295720334,Hawkish
금리/NNG;인상/NNG;위험/NNG,14,7,21,1.812761636396349,Hawkish
전망/NNG;높/VV,13,9,22,1.309216737397363,Hawkish
순환기/NNG,71,26,97,2.4751168496950147,Hawkish
흔하/VA,25,17,42,1.332912967938492,Hawkish
트리/NNG,201,138,339,1.3201633656364715,Hawkish
국유/NNG,38,20,58,1.7221235545765314,Hawkish
물가/NNG;예상/NNG;하회/NNG,12,8,20,1.3595712272972615,Hawkish
지구단위계획/NNG,17,4,21,3.852118477342241,Hawkish
라스트/NNG,29,14,43,1.8775031234105044,Hawkish
커머스/NNG,35,20,55,1.5861664318468052,Hawkish
클수록/VV,52,29,81,1.6252345705622437,Hawkish
깔린/VV,15,7,22,1.9422446104246596,Hawkish
기관계/NNG,81,55,136,1.3348517504373116,Hawkish
부채/NNG;급증/NNG,22,7,29,2.848625428622834,Hawkish
똑똑/NNG,16,7,23,2.0717275844529706,Hawkish
증진/NNG,31,16,47,1.756112835258963,Hawkish
비유동자산/NNG,15,9,24,1.5106346969969573,Hawkish
수산/NNG,15,8,23,1.699464034121577,Hawkish
계통/NNG,14,9,23,1.4099257171971604,Hawkish
스크린/NNG,21,10,31,1.9033997182161664,Hawkish
최저/NNG;하락/NNG,35,22,57,1.4419694834970957,Hawkish
분출/NNG,13,7,20,1.6832786623680382,Hawkish
눈치보/VV,55,17,72,2.9324085294646816,Hawkish
긴장/NNG,634,366,1000,1.5700695047476574,Hawkish
뜨거워서/VA,18,2,20,8.15742736378357,Hawkish
마이너스/NNG;전환/NNG,61,33,94,1.6754312093966257,Hawkish
글로벌/NNG;경제/NNG;성장/NNG,17,8,25,1.9260592386711206,Hawkish
치부/NNG,28,13,41,1.9522048391960678,Hawkish
취득세/NNG,25,13,38,1.7430400349964892,Hawkish
기간물/NNG,45,27,72,1.5106346969969573,Hawkish
복복/MAG,231,107,338,1.9567660654558718,Hawkish
안고/NNG,41,10,51,3.716161354612515,Hawkish
소비/NNG;모멘텀/NNG,23,10,33,2.084675881855801,Hawkish
도심/NNG,55,33,88,1.5106346969969575,Hawkish
비즈니스모델/NNG,19,11,30,1.5655668677968468,Hawkish
채웠/VV,64,43,107,1.3490319154577481,Hawkish
정체국면/NNG,14,8,22,1.5861664318468052,Hawkish
지방은행/NNG,166,102,268,1.4750903511852644,Hawkish
상장주식/NNG,28,14,42,1.812761636396349,Hawkish
기스/NNG,20,9,29,2.0141795959959437,Hawkish
기업/NNG;대출/NNG;확대/NNG,11,7,18,1.424312714311417,Hawkish
상승룸/NNG,13,6,19,1.9638251060960445,Hawkish
우우우/MAG,57,28,85,1.8451323799034267,Hawkish
치킨/NNG,18,7,25,2.3306935325095917,Hawkish
올올/NNG,69,34,103,1.8394198957551187,Hawkish
對美/NNG,11,6,17,1.661698166696653,Hawkish
높/VA;긴축/NNG,49,27,76,1.6449133367300204,Hawkish
절망/NNG,15,3,18,4.531904090990872,Hawkish
사용액/NNG,14,7,21,1.812761636396349,Hawkish
영업외수익/NNG,32,8,40,3.6255232727926976,Hawkish
수입관세/NNG,12,5,17,2.1753139636756185,Hawkish
차질/NNG,356,205,561,1.5740076647734151,Hawkish
인터랙티브/NNG,23,5,28,4.169351763711602,Hawkish
신고서/NNG,17,6,23,2.5680789848948273,Hawkish
견실/NNG,143,77,220,1.6832786623680385,Hawkish
두기/NNG,109,15,124,6.586367278906734,Hawkish
변했/VV,37,25,62,1.3414436109332981,Hawkish
노동/NNG;공급/NNG;증가/NNG,12,7,19,1.5537956883397277,Hawkish
저축/NNG;감소/NNG,14,6,20,2.1148885757957405,Hawkish
점수/NNG,150,73,223,1.8624263387633722,Hawkish
통화정책/NNG;불확실성/NNG;해소/NNG,32,9,41,3.222687353593509,Hawkish
양호/NNG;회복/NNG,27,7,34,3.4960402987643877,Hawkish
대학/NNG,184,117,301,1.425419406397129,Hawkish
금리/NNG;인하/NNG;기대/NNG;위축/NNG,32,13,45,2.2310912447955062,Hawkish
구정/NNG,29,13,42,2.0219264405959274,Hawkish
기자단/NNG,33,8,41,3.7388208750674696,Hawkish
발작/NNG,61,37,98,1.4943035110834768,Hawkish
평화/NNG,50,32,82,1.4162200284346476,Hawkish
완성/NNG,60,29,89,1.8752706583410503,Hawkish
연방기관채/NNG,69,23,92,2.7191424545945235,Hawkish
라운드/NNG,32,20,52,1.4502093091170791,Hawkish
안개/NNG,32,13,45,2.2310912447955062,Hawkish
맞먹/VV,12,7,19,1.5537956883397277,Hawkish
상고하저/NNG,79,29,108,2.4691063668157165,Hawkish
불확실성/NNG;경계/NNG,19,13,32,1.3247104265973317,Hawkish
하방/NNG;경직/NNG,36,21,57,1.5537956883397277,Hawkish
자금/NNG;유출/NNG;우려/NNG,19,9,28,1.9134706161961461,Hawkish
회복/NNG;약화/NNG,13,5,18,2.3565901273152536,Hawkish
감원/NNG,143,54,197,2.4002306852284994,Hawkish
인플레이션/NNG;예상/NNG;높/VA,17,11,28,1.4007703553971786,Hawkish
인플레이션/NNG;압력/NNG;완화/NNG,57,20,77,2.5831853318647973,Hawkish
활주로/NNG,27,5,32,4.894456418270142,Hawkish
페이퍼/NNG,38,15,53,2.2961647394353752,Hawkish
박진/NNG,176,67,243,2.3809406567593836,Hawkish
인허가/NNG,96,29,125,3.0004330533456804,Hawkish
수주/NNG;부진/NNG,18,10,28,1.631485472756714,Hawkish
계소/NNG,18,7,25,2.3306935325095917,Hawkish
농민/NNG,34,12,46,2.5680789848948273,Hawkish
위험/NNG;회피/NNG;크/VV,12,7,19,1.5537956883397277,Hawkish
개인연금/NNG,34,2,36,15.408473909368965,Hawkish
공공요금/NNG;인상/NNG;상승/NNG,13,4,17,2.9457376591440667,Hawkish
농산물/NNG;가격/NNG;상승/NNG,21,14,35,1.3595712272972618,Hawkish
해외부문/NNG,45,25,70,1.6314854727567139,Hawkish
게게/MAG,173,58,231,2.703515199108348,Hawkish
국채/NNG;약세/NNG,12,5,17,2.1753139636756185,Hawkish
징조/NNG,32,10,42,2.9004186182341583,Hawkish
살살/MAG,21,5,26,3.8067994364323328,Hawkish
스탠더드/NNG,29,16,45,1.6428152329841912,Hawkish
구가/NNG,29,8,37,3.2856304659683824,Hawkish
투자/NNG;활성화/NNG,22,15,37,1.3293585333573226,Hawkish
전망/NNG;저점/NNG,12,6,18,1.8127616363963488,Hawkish
첫해/NNG,15,8,23,1.699464034121577,Hawkish
컨센서스/NNG;웃돌/VV,13,6,19,1.9638251060960445,Hawkish
변할지/VV,16,8,24,1.8127616363963488,Hawkish
전망/NNG;상방/NNG;위험/NNG,37,7,44,4.790870039047493,Hawkish
글로벌/NNG;금리/NNG;급등/NNG,17,11,28,1.4007703553971786,Hawkish
환경지수/NNG,54,25,79,1.9577825673080569,Hawkish
위수/NNG,15,7,22,1.9422446104246596,Hawkish
ndf시장/NNG,34,22,56,1.4007703553971786,Hawkish
성장/NNG;강하/VA,16,5,21,2.9004186182341583,Hawkish
이슈기업/NNG,19,2,21,8.610617772882657,Hawkish
의무지출/NNG,18,6,24,2.7191424545945235,Hawkish
경제/NNG;훼손/NNG,16,4,20,3.6255232727926976,Hawkish
유동비율/NNG,75,24,99,2.832440056869295,Hawkish
가격/NNG;인상/NNG,75,48,123,1.4162200284346476,Hawkish
중소형사/NNG,54,32,86,1.5295176307094194,Hawkish
하락장/NNG,37,24,61,1.3973370947221855,Hawkish
대외/NNG;불안/NNG,16,9,25,1.6113436767967546,Hawkish
베버리지곡선/NNG,31,10,41,2.8097805364143404,Hawkish
감돌/VV,24,5,29,4.350627927351237,Hawkish
잉여자금/NNG,16,10,26,1.4502093091170791,Hawkish
흥행/NNG;성공/NNG,79,48,127,1.4917517632844954,Hawkish
세분화/NNG,70,31,101,2.046666363673297,Hawkish
우려/NNG;없/VA,19,11,30,1.5655668677968468,Hawkish
물가/NNG;불확실성/NNG,57,30,87,1.7221235545765314,Hawkish
널뛰기/NNG,16,11,27,1.3183720991973447,Hawkish
분경/NNG,21,10,31,1.9033997182161664,Hawkish
모양새/NNG,150,104,254,1.307280026247367,Hawkish
엔지니어링/NNG,62,30,92,1.8731870242762272,Hawkish
포위/NNG,19,2,21,8.610617772882657,Hawkish
합쳐/VV,107,69,176,1.4055470659015168,Hawkish
최대/NNG;증가/NNG,34,13,47,2.370534447595225,Hawkish
공시이율/NNG,58,1,59,52.57008745549412,Hawkish
글로벌/NNG;통화/NNG;긴축/NNG,18,12,30,1.3595712272972618,Hawkish
글로벌/NNG;위험/NNG;회피/NNG,13,9,22,1.309216737397363,Hawkish
자본지출/NNG;부담/NNG,11,6,17,1.661698166696653,Hawkish
금리재정거래/NNG,21,14,35,1.3595712272972618,Hawkish
생산비/NNG,17,6,23,2.5680789848948273,Hawkish
유로5/NNG,36,21,57,1.5537956883397277,Hawkish
조달처/NNG,13,4,17,2.9457376591440667,Hawkish
자금사정/NNG;악화/NNG,12,5,17,2.1753139636756185,Hawkish
정책/NNG;제약/NNG,20,9,29,2.0141795959959437,Hawkish
전수조사/NNG,12,8,20,1.3595712272972615,Hawkish
주원/NNG,116,29,145,3.625523272792698,Hawkish
금리/NNG;인하/NNG;전망/NNG;후퇴/NNG,39,21,60,1.6832786623680382,Hawkish
국채/NNG;축소/NNG,21,6,27,3.1723328636936103,Hawkish
대출비중/NNG,195,132,327,1.3389716632473032,Hawkish
전조/NNG,23,10,33,2.084675881855801,Hawkish
여력/NNG;높/VV,12,7,19,1.5537956883397277,Hawkish
매도전략/NNG,739,299,1038,2.240185366717227,Hawkish
가격/NNG;급락/NNG,46,29,75,1.4377075047281387,Hawkish
환적/NNG,13,5,18,2.3565901273152536,Hawkish
구성원/NNG,349,124,473,2.5510234318642167,Hawkish
성장/NNG;모멘텀/NNG;둔화/NNG,13,8,21,1.4728688295720334,Hawkish
펀더멘털/NNG;불확실성/NNG,17,10,27,1.5408473909368965,Hawkish
빈자리/NNG,16,5,21,2.9004186182341583,Hawkish
곳곳/NNG,57,35,92,1.4761059039227413,Hawkish
시니어/NNG,26,12,38,1.9638251060960445,Hawkish
경제/NNG;견실/NNG;성장/NNG,15,6,21,2.265952045495436,Hawkish
지표/NNG;금리/NNG;인상/NNG,15,8,23,1.699464034121577,Hawkish
전념/NNG,41,9,50,4.129068171791683,Hawkish
납세/NNG,24,11,35,1.977558148796017,Hawkish
내밀/VV,13,7,20,1.6832786623680382,Hawkish
비비비비/MAG,303,188,491,1.4608158931598236,Hawkish
설비/NNG;투자/NNG;부진/NNG,22,15,37,1.3293585333573226,Hawkish
자산/NNG;성장/NNG,30,13,43,2.091648041995787,Hawkish
되려/MAG,14,7,21,1.812761636396349,Hawkish
불합격/NNG,14,3,17,4.229777151591481,Hawkish
경기/NNG;선행/NNG;지수/NNG;하락/NNG,22,13,35,1.5338752307969103,Hawkish
재가동/NNG,21,14,35,1.3595712272972618,Hawkish
개선/NNG;견인/NNG,13,4,17,2.9457376591440667,Hawkish
변모/NNG,25,14,39,1.618537175353883,Hawkish
결정일/NNG,32,14,46,2.0717275844529706,Hawkish
추계/NNG,34,18,52,1.7120526565965517,Hawkish
전망/NNG;하회/NNG,60,31,91,1.7542854545771116,Hawkish
수입/NNG;감소/NNG,43,26,69,1.4990144300969808,Hawkish
가치투자/NNG,15,2,17,6.797856136486308,Hawkish
차단/NNG,242,162,404,1.3539762839750509,Hawkish
수도/NNG,247,120,367,1.8656338507912427,Hawkish
네트웍스/NNG,24,10,34,2.1753139636756185,Hawkish
소문/NNG,37,16,53,2.096005642083278,Hawkish
우하향/NNG,29,16,45,1.6428152329841912,Hawkish
수입업체/NNG,39,15,54,2.3565901273152536,Hawkish
상당량/NNG,12,5,17,2.1753139636756185,Hawkish
위탁운용사/NNG,33,18,51,1.6616981666966535,Hawkish
순덕/NNG,77,25,102,2.7916529200503772,Hawkish
소프트패치/NNG,25,11,36,2.059956404995851,Hawkish
주상복합/NNG,23,3,26,6.948919606186004,Hawkish
누차/MAG,19,11,30,1.5655668677968468,Hawkish
사용처/NNG,13,5,18,2.3565901273152536,Hawkish
종사/NNG,21,12,33,1.5861664318468052,Hawkish
요격/NNG,19,3,22,5.740411848588438,Hawkish
금리/NNG;통제/NNG,11,6,17,1.661698166696653,Hawkish
재무/NNG;부담/NNG;증가/NNG,18,12,30,1.3595712272972618,Hawkish
통화/NNG;절하/NNG,26,16,42,1.4728688295720334,Hawkish
하루치/NNG,22,7,29,2.848625428622834,Hawkish
와일드카드/NNG,17,6,23,2.5680789848948273,Hawkish
스텝/NNG,474,99,573,4.33964149319126,Hawkish
자치/NNG,43,23,66,1.6945380514139783,Hawkish
선제/NNG;금리/NNG;인하/NNG,44,21,65,1.8990836190818892,Hawkish
부동산/NNG;안정/NNG,24,13,37,1.6733184335966296,Hawkish
경협/NNG,28,7,35,3.625523272792698,Hawkish
예약/NNG,27,17,44,1.4395460053735711,Hawkish
과도/NNG;금리/NNG;인하/NNG,11,6,17,1.661698166696653,Hawkish
임금/NNG;상승률/NNG;낮/VA,13,6,19,1.9638251060960445,Hawkish
혼선/NNG,33,21,54,1.424312714311417,Hawkish
무색/NNG,42,20,62,1.9033997182161664,Hawkish
계한/NNG,15,7,22,1.9422446104246596,Hawkish
현명/NNG,70,31,101,2.046666363673297,Hawkish
공중/NNG,38,16,54,2.1526544432206642,Hawkish
부연/VA,22,14,36,1.424312714311417,Hawkish
알파벳/NNG,299,206,505,1.31557215845269,Hawkish
단하/NNG,11,6,17,1.661698166696653,Hawkish
경제/NNG;성장률/NNG;높/VA,14,7,21,1.812761636396349,Hawkish
지정학/NNG;위험/NNG;우려/NNG,17,11,28,1.4007703553971786,Hawkish
약화/NNG;우려/NNG,21,14,35,1.3595712272972618,Hawkish
고용/NNG;견조/NNG,37,13,50,2.579699251794804,Hawkish
증권회사/NNG,45,29,74,1.406452993755788,Hawkish
미비/NNG,30,13,43,2.091648041995787,Hawkish
어닝서프라이즈/NNG,99,52,151,1.7256096346465242,Hawkish
모기지/NNG;금리/NNG;급등/NNG,18,9,27,1.812761636396349,Hawkish
평균치/NNG,351,229,580,1.3892561885919619,Hawkish
건실/NNG,12,7,19,1.5537956883397277,Hawkish
원가/NNG;부담/NNG,29,15,44,1.7523362485164709,Hawkish
역기/NNG,43,9,52,4.330486131391278,Hawkish
금리/NNG;인하/NNG;불투명/NNG,22,8,30,2.4925472500449795,Hawkish
종자/NNG,12,6,18,1.8127616363963488,Hawkish
기은/NNG,24,12,36,1.8127616363963488,Hawkish
창창/MAG,18,8,26,2.0393568409458926,Hawkish
보임/NNG,120,65,185,1.6733184335966296,Hawkish
사업비/NNG,94,39,133,2.1846101771955997,Hawkish
당분간/MAG;금리/NNG;인상/NNG,17,7,24,2.201210558481281,Hawkish
남동/NNG,15,9,24,1.5106346969969573,Hawkish
생생/MAG,105,61,166,1.5601637034558742,Hawkish
사업장/NNG,847,480,1327,1.5993844854455286,Hawkish
예산처/NNG,24,8,32,2.719142454594523,Hawkish
테일러준칙/NNG,161,106,267,1.3766727521689253,Hawkish
중위소득/NNG,12,6,18,1.8127616363963488,Hawkish
기대/NNG;인플레이션/NNG;상승/NNG,139,68,207,1.8527490254345036,Hawkish
자본/NNG;감소/NNG,18,4,22,4.078713681891785,Hawkish
바라봐야/VV,15,10,25,1.3595712272972615,Hawkish
최고조/NNG,25,13,38,1.7430400349964892,Hawkish
부족자금/NNG,11,6,17,1.661698166696653,Hawkish
투자/NNG;축소/NNG,22,14,36,1.424312714311417,Hawkish
국세/NNG,148,28,176,4.790870039047493,Hawkish
다분/NNG,16,8,24,1.8127616363963488,Hawkish
도중/NNG,31,18,49,1.560989186896856,Hawkish
인상/NNG;지지/NNG,28,13,41,1.9522048391960678,Hawkish
경기/NNG;둔화/NNG;위험/NNG,15,7,22,1.9422446104246596,Hawkish
년대말/NNG,20,12,32,1.5106346969969575,Hawkish
발행주식수/NNG,19,3,22,5.740411848588438,Hawkish
쿼터/NNG,19,13,32,1.3247104265973317,Hawkish
상방/NNG,946,593,1539,1.4459296020497014,Hawkish
당해/VV,22,10,32,1.9940378000359835,Hawkish
전함/NNG,18,5,23,3.262970945513428,Hawkish
완승/NNG,17,4,21,3.852118477342241,Hawkish
트렌치/NNG,121,76,197,1.4430536710786726,Hawkish
대출포트폴리오/NNG,24,14,38,1.5537956883397277,Hawkish
예상/NNG;작/VA,29,12,41,2.1904203106455884,Hawkish
사회관계망/NNG,14,7,21,1.812761636396349,Hawkish
연방정부/NNG,235,115,350,1.8521694980571393,Hawkish
폭등/NNG,16,10,26,1.4502093091170791,Hawkish
인상/NNG;가능성/NNG;낮/VA,28,16,44,1.5861664318468052,Hawkish
자의/NNG,21,14,35,1.3595712272972618,Hawkish
속단/NNG,14,9,23,1.4099257171971604,Hawkish
방위/NNG,69,44,113,1.4213699194471374,Hawkish
맡긴/VV,59,24,83,2.228186178070512,Hawkish
역풍/NNG,75,51,126,1.332912967938492,Hawkish
우려/NNG;하락/NNG,32,19,51,1.5265361148600833,Hawkish
고용/NNG;양호/NNG,39,26,65,1.3595712272972615,Hawkish
모았/VV,104,67,171,1.4069194789941812,Hawkish
금상/NNG,25,10,35,2.2659520454954363,Hawkish
둔화/NNG;추세/NNG,128,87,215,1.3335258014869693,Hawkish
투자여력/NNG,30,12,42,2.265952045495436,Hawkish
미지/NNG,13,9,22,1.309216737397363,Hawkish
앵커/NNG,118,75,193,1.4260391539651278,Hawkish
릴레이/NNG,18,12,30,1.3595712272972618,Hawkish
수익성/NNG;낮/VA,21,7,28,2.7191424545945235,Hawkish
성장/NNG;금융안정/NNG,13,8,21,1.4728688295720334,Hawkish
회의실/NNG,22,12,34,1.661698166696653,Hawkish
수출/NNG;부진/NNG;완화/NNG,17,10,27,1.5408473909368965,Hawkish
가미/NNG,38,17,55,2.0260277112665075,Hawkish
충당금/NNG,448,253,701,1.604974729457637,Hawkish
고용시장/NNG;강세/NNG,16,4,20,3.6255232727926976,Hawkish
체이스/NNG,115,77,192,1.3536856375687023,Hawkish
수비대/NNG,29,5,34,5.257008745549412,Hawkish
구호/NNG,36,25,61,1.3051883782053713,Hawkish
재본/NNG,30,11,41,2.471947685995021,Hawkish
방망이/NNG,20,7,27,2.589659480566213,Hawkish
행할/VV,21,4,25,4.758499295540416,Hawkish
원만/NNG,20,11,31,1.647965123996681,Hawkish
정책/NNG;금리/NNG;인상/NNG,15,4,19,3.398928068243154,Hawkish
가계/NNG;이자/NNG;부담/NNG,16,3,19,4.834031030390264,Hawkish
후후후/MAG,112,65,177,1.5617638713568545,Hawkish
못지않/VA,24,14,38,1.5537956883397277,Hawkish
예상/NNG;상향/NNG,23,12,35,1.737229901546501,Hawkish
인상/NNG;사이클/NNG;종료/NNG,24,11,35,1.977558148796017,Hawkish
산업부/NNG,49,15,64,2.9608440061140366,Hawkish
전망/NNG;늘/VV,13,7,20,1.6832786623680382,Hawkish
시니어론/NNG,117,71,188,1.4936134609744565,Hawkish
높/VA;금리/NNG;부담/NNG,13,9,22,1.309216737397363,Hawkish
둔화/NNG;조짐/NNG,58,31,89,1.6958092727578746,Hawkish
남겨둔/VV,24,11,35,1.977558148796017,Hawkish
물가/NNG;둔화/NNG,326,200,526,1.4774007336630242,Hawkish
담겨/VV,24,15,39,1.4502093091170791,Hawkish
대두가격/NNG,11,6,17,1.661698166696653,Hawkish
반덤핑/NNG,11,6,17,1.661698166696653,Hawkish
국채/NNG;금리/NNG;소폭/MAG;상승/NNG,13,7,20,1.6832786623680382,Hawkish
료의/NNG,23,8,31,2.6058448523197515,Hawkish
전망/NNG;인상/NNG,32,15,47,1.9336124121561056,Hawkish
모빌리티/NNG,39,27,66,1.309216737397363,Hawkish
속사정/NNG,15,7,22,1.9422446104246596,Hawkish
셈법/NNG,32,18,50,1.6113436767967546,Hawkish
세적/NNG,12,6,18,1.8127616363963488,Hawkish
금리/NNG;인하/NNG;지지/NNG,38,21,59,1.6401176710252678,Hawkish
사민/NNG,23,6,29,3.474459803093002,Hawkish
만약/NNG;금리/NNG;인하/NNG,14,9,23,1.4099257171971604,Hawkish
후원/NNG,18,11,29,1.4831686115970129,Hawkish
어지/NNG,15,9,24,1.5106346969969573,Hawkish
원점/NNG,46,23,69,1.812761636396349,Hawkish
우려/NNG;확대/NNG,78,54,132,1.309216737397363,Hawkish
공화당/NNG,647,360,1007,1.6289677482617189,Hawkish
상단/NNG;금리/NNG;하단/NNG,18,10,28,1.631485472756714,Hawkish
동행/NNG,516,281,797,1.6643861287909536,Hawkish
원할/VV,43,8,51,4.871796897815187,Hawkish
의사록/NNG,950,575,1525,1.497498743110027,Hawkish
금리/NNG;인하/NNG;지연/NNG,286,124,410,2.0905235000377247,Hawkish
국고채/NNG;고점/NNG,14,9,23,1.4099257171971604,Hawkish
위험/NNG;지정학/NNG;위험/NNG,14,7,21,1.812761636396349,Hawkish
지정학/NNG;위험/NNG;증가/NNG,11,7,18,1.424312714311417,Hawkish
금리/NNG;충격/NNG,15,10,25,1.3595712272972615,Hawkish
복지/NNG,219,149,368,1.3321973099691289,Hawkish
팽팽/NNG,33,22,55,1.3595712272972618,Hawkish
경제/NNG;지표/NNG;예상/NNG;하회/NNG,12,8,20,1.3595712272972615,Hawkish
문문/NNG,257,139,396,1.6758264048700058,Hawkish
소비/NNG;제약/NNG,16,7,23,2.0717275844529706,Hawkish
안정/NNG;추세/NNG,15,7,22,1.9422446104246596,Hawkish
지정학/NNG;위험/NNG,377,223,600,1.5323119661915325,Hawkish
전문직/NNG,20,10,30,1.812761636396349,Hawkish
응답비율/NNG,13,6,19,1.9638251060960445,Hawkish
msci/NNG,2668,1850,4518,1.3071481205149889,Hawkish
도매업/NNG,23,13,36,1.6035968321967702,Hawkish
근원/NNG;소비자/NNG;물가/NNG;상승/NNG,14,5,19,2.5378662909548884,Hawkish
제조업/NNG;경기/NNG;개선/NNG,13,7,20,1.6832786623680382,Hawkish
세수입/NNG,16,10,26,1.4502093091170791,Hawkish
상방/NNG;압력/NNG,132,88,220,1.3595712272972618,Hawkish
사회/NNG,1699,942,2641,1.6347569109540323,Hawkish
차년/NNG,15,7,22,1.9422446104246596,Hawkish
방어력/NNG,35,12,47,2.643610719744675,Hawkish
위험/NNG;가계/NNG;부채/NNG;증가/NNG,30,9,39,3.0212693939939146,Hawkish
부족분/NNG,49,26,75,1.7081792342965594,Hawkish
발행/NNG;금리/NNG;상승/NNG,11,7,18,1.424312714311417,Hawkish
구한/VV,11,7,18,1.424312714311417,Hawkish
가져갈/VV,57,38,95,1.3595712272972618,Hawkish
세기/NNG,28,19,47,1.3357191005025728,Hawkish
각오/NNG,31,13,44,2.1613696433956466,Hawkish
재정/NNG;적자/NNG;개선/NNG,13,6,19,1.9638251060960445,Hawkish
潮流/NNG,37,1,38,33.53609027333245,Hawkish
채권/NNG;위험/NNG,17,9,26,1.7120526565965517,Hawkish
세계/NNG;경제/NNG;높/VA,37,6,43,5.589348378888742,Hawkish
패패/NNG,17,11,28,1.4007703553971786,Hawkish
내수/NNG;침체/NNG,15,6,21,2.265952045495436,Hawkish
자산배분/NNG,732,509,1241,1.3034788976838185,Hawkish
석수/NNG,36,22,58,1.4831686115970129,Hawkish
비금융사/NNG,15,7,22,1.9422446104246596,Hawkish
경제관계장관회의/NNG,12,7,19,1.5537956883397277,Hawkish
미실현손실/NNG,67,7,74,8.675359259896814,Hawkish
재투자/NNG;중단/NNG,58,27,85,1.9470402761294119,Hawkish
이원/NNG,13,4,17,2.9457376591440667,Hawkish
하락룸/NNG,81,49,130,1.4983029851847374,Hawkish
이중고/NNG,27,16,43,1.5295176307094194,Hawkish
투자/NNG;둔화/NNG,18,10,28,1.631485472756714,Hawkish
오인/NNG,19,12,31,1.4351029621471094,Hawkish
대외/NNG;여건/NNG;악화/NNG,12,6,18,1.8127616363963488,Hawkish
경제/NNG;성장률/NNG;상향/NNG,33,23,56,1.3004594348060765,Hawkish
단기투자자/NNG,17,4,21,3.852118477342241,Hawkish
불발/NNG,60,41,101,1.3264109534607431,Hawkish
양원/NNG,16,5,21,2.9004186182341583,Hawkish
수긍/NNG,13,9,22,1.309216737397363,Hawkish
유동성/NNG;낮/VA,16,9,25,1.6113436767967546,Hawkish
환경규제/NNG,18,11,29,1.4831686115970129,Hawkish
동종/NNG,31,13,44,2.1613696433956466,Hawkish
드리/VV,208,119,327,1.584262270464036,Hawkish
금리/NNG;예상/NNG;높/VA,26,11,37,2.142354661195685,Hawkish
그린본드/NNG,75,52,127,1.307280026247367,Hawkish
나비효과/NNG,14,5,19,2.5378662909548884,Hawkish
약자/NNG,23,16,39,1.3029224261598757,Hawkish
높/VA;끝/NNG,14,6,20,2.1148885757957405,Hawkish
국경세/NNG,16,1,17,14.50209309117079,Hawkish
온의/NNG,11,7,18,1.424312714311417,Hawkish
기후/NNG,354,230,584,1.3950383027919728,Hawkish
오로지/MAG,28,16,44,1.5861664318468052,Hawkish
실거주/NNG,17,4,21,3.852118477342241,Hawkish
신속/NNG,272,176,448,1.4007703553971786,Hawkish
국채선물/NNG;순매도/NNG;전환/NNG;수급/NNG;부담/NNG,16,5,21,2.9004186182341583,Hawkish
조한/NNG,19,12,31,1.4351029621471094,Hawkish
그은/VV,15,10,25,1.3595712272972615,Hawkish
단기물/NNG;금리/NNG;스프레드/NNG;부담/NNG,24,4,28,5.438284909189046,Hawkish
평시/NNG,23,11,34,1.895159892596183,Hawkish
경경제제/NNG,229,139,368,1.4932460961682155,Hawkish
예상/NNG;더디/VA,49,32,81,1.3878956278659547,Hawkish
조립/NNG,15,10,25,1.3595712272972615,Hawkish
자영업/NNG,45,27,72,1.5106346969969573,Hawkish
발행한도/NNG,154,100,254,1.3958264600251886,Hawkish
국주/NNG,29,20,49,1.314252186387353,Hawkish
통화/NNG;긴축/NNG;강화/NNG,17,11,28,1.4007703553971786,Hawkish
예상/NNG;상승/NNG;상회/NNG,22,10,32,1.9940378000359835,Hawkish
빌라/NNG,76,33,109,2.0874224903957956,Hawkish
에너지의존도/NNG,20,2,22,9.063808181981745,Hawkish
양날/NNG,21,7,28,2.7191424545945235,Hawkish
떨치/VV,21,13,34,1.464153629397051,Hawkish
주거비/NNG,500,325,825,1.3944320279971913,Hawkish
접촉/NNG,103,51,154,1.8305338093021954,Hawkish
보이스피싱/NNG,29,17,46,1.5461790428086506,Hawkish
전망/NNG;하향/NNG;안정/NNG,22,9,31,2.2155975555955374,Hawkish
인상/NNG;상승/NNG,16,5,21,2.9004186182341583,Hawkish
정치인/NNG,39,26,65,1.3595712272972615,Hawkish
백금/NNG,21,8,29,2.379249647770208,Hawkish
소비/NNG;회복/NNG,65,45,110,1.3092167373973629,Hawkish
인되/VV,16,6,22,2.417015515195132,Hawkish
고정이하여신/NNG,65,36,101,1.6365209217467038,Hawkish
유학/NNG,17,9,26,1.7120526565965517,Hawkish
양도/NNG,55,37,92,1.3473228378621511,Hawkish
정부자금/NNG,18,12,30,1.3595712272972618,Hawkish
무디/VA,11,6,17,1.661698166696653,Hawkish
전망/NNG;높/VA,75,45,120,1.5106346969969573,Hawkish
금리/NNG;확대/NNG,16,11,27,1.3183720991973447,Hawkish
기대/NNG;어렵/VA,18,9,27,1.812761636396349,Hawkish
긴축/NNG;강화/NNG,49,21,70,2.11488857579574,Hawkish
배출/NNG,181,81,262,2.025369482640365,Hawkish
구인난/NNG,29,3,32,8.761681242582354,Hawkish
오르르/MAG,14,3,17,4.229777151591481,Hawkish
공급/NNG;불안/NNG,17,7,24,2.201210558481281,Hawkish
착착/MAG,15,3,18,4.531904090990872,Hawkish
성장/NNG;개선/NNG,28,11,39,2.3071511735953534,Hawkish
낮/VA;인하/NNG,16,9,25,1.6113436767967546,Hawkish
시장경제/NNG,28,9,37,2.819851434394321,Hawkish
컨트리/NNG,23,9,32,2.3163065353953347,Hawkish
자제/NNG,174,121,295,1.3033905980701022,Hawkish
간간/MAG,196,134,330,1.3257510475137477,Hawkish
통방문구/NNG,17,9,26,1.7120526565965517,Hawkish
성명문/NNG,117,80,197,1.3255819466148302,Hawkish
접객/NNG,95,21,116,4.10029417756317,Hawkish
fed/NNG;경기/NNG;침체/NNG,22,3,25,6.646792666786612,Hawkish
청정에너지/NNG,21,10,31,1.9033997182161664,Hawkish
소환/NNG,45,31,76,1.3157140909328338,Hawkish
숄더/NNG,14,5,19,2.5378662909548884,Hawkish
인플레이션/NNG;악화/NNG,16,4,20,3.6255232727926976,Hawkish
실적/NNG;호조/NNG,102,52,154,1.7779008356964188,Hawkish
유망섹터/NNG,11,6,17,1.661698166696653,Hawkish
내려갈게요/VV,31,1,32,28.097805364143408,Hawkish
달성군/NNG,24,2,26,10.876569818378092,Hawkish
금리/NNG;스프레드/NNG;부담/NNG,33,4,37,7.477641750134939,Hawkish
후기/NNG,12,5,17,2.1753139636756185,Hawkish
제안/NNG,869,593,1462,1.328237657696819,Hawkish
타진/VV,36,2,38,16.31485472756714,Hawkish
보존/NNG,88,54,142,1.4770650370636915,Hawkish
주식분할/NNG,33,11,44,2.7191424545945235,Hawkish
최저/NNG;내리/VV,15,10,25,1.3595712272972615,Hawkish
물가/NNG;상승/NNG;금리/NNG;인하/NNG,12,5,17,2.1753139636756185,Hawkish
연체율/NNG;낮/VA,11,6,17,1.661698166696653,Hawkish
양안/NNG,24,3,27,7.251046545585395,Hawkish
카테고리/NNG,35,18,53,1.7624071464964504,Hawkish
전치/NNG,14,9,23,1.4099257171971604,Hawkish
한가/NNG,21,6,27,3.1723328636936103,Hawkish
즉각/MAG,193,131,324,1.3353549458950205,Hawkish
국채선물/NNG;가격/NNG;상승/NNG,18,9,27,1.812761636396349,Hawkish
맞대응/NNG,12,5,17,2.1753139636756185,Hawkish
가사/NNG,78,38,116,1.8604658899857265,Hawkish
옮겨간/VV,11,7,18,1.424312714311417,Hawkish
지리/NNG,35,21,56,1.5106346969969573,Hawkish
혼자/NNG,12,7,19,1.5537956883397277,Hawkish
지출비중/NNG,30,15,45,1.8127616363963488,Hawkish
허가/NNG,187,103,290,1.6455651747869768,Hawkish
분양/NNG,811,240,1051,3.062811848161331,Hawkish
fed/NNG;물가/NNG;안정/NNG,39,16,55,2.20930324435805,Hawkish
자금/NNG;조달/NNG;부담/NNG,13,6,19,1.9638251060960445,Hawkish
안갯속/NNG,13,9,22,1.309216737397363,Hawkish
예상/NNG;웃돌/VV;금리/NNG;인하/NNG,19,8,27,2.1526544432206642,Hawkish
존속/NNG,25,17,42,1.332912967938492,Hawkish
실적/NNG;저조/NNG,22,7,29,2.848625428622834,Hawkish
제조사/NNG,35,22,57,1.4419694834970957,Hawkish
이노베이션/NNG,18,6,24,2.7191424545945235,Hawkish
강자/NNG,20,10,30,1.812761636396349,Hawkish
통화정책/NNG;성장/NNG,15,7,22,1.9422446104246596,Hawkish
이티/NNG,36,18,54,1.812761636396349,Hawkish
성장/NNG;우려/NNG,20,13,33,1.3944320279971913,Hawkish
호황국면/NNG,47,23,70,1.8521694980571393,Hawkish
교환사채/NNG,17,7,24,2.201210558481281,Hawkish
기중/NNG,24,9,33,2.417015515195132,Hawkish
수요/NNG;감소/NNG;우려/NNG,15,7,22,1.9422446104246596,Hawkish
물가/NNG;전망/NNG;상방/NNG,27,5,32,4.894456418270142,Hawkish
인플레이션/NNG;경계/NNG,89,28,117,2.8809961721299118,Hawkish
기대/NNG;과도/NNG,16,7,23,2.0717275844529706,Hawkish
보입니다/VV,47,24,71,1.774995768971425,Hawkish
불러일으킬/VV,18,12,30,1.3595712272972618,Hawkish
금리/NNG;인상/NNG;중단/NNG,52,23,75,2.04920880636109,Hawkish
기다림/VV,37,15,52,2.235739351555497,Hawkish
실적/NNG;부담/NNG,15,10,25,1.3595712272972615,Hawkish
채권비중/NNG;확대/NNG,20,12,32,1.5106346969969575,Hawkish
주주행동주의/NNG,13,5,18,2.3565901273152536,Hawkish
실지/MAG,12,6,18,1.8127616363963488,Hawkish
경기/NNG;과열/NNG,27,18,45,1.3595712272972618,Hawkish
위험/NNG;약화/NNG,11,7,18,1.424312714311417,Hawkish
가격/NNG;상승/NNG;압력/NNG,29,16,45,1.6428152329841912,Hawkish
보충/NNG,75,40,115,1.6994640341215772,Hawkish
금리/NNG;상단/NNG;높/VA,11,6,17,1.661698166696653,Hawkish
가격/NNG;상승/NNG;일시적/VAX,15,3,18,4.531904090990872,Hawkish
순수익/NNG,52,20,72,2.3565901273152536,Hawkish
늦춘다/VV,12,7,19,1.5537956883397277,Hawkish
인상/NNG;없/VA,29,17,46,1.5461790428086506,Hawkish
대주/NNG,81,46,127,1.5960183972620028,Hawkish
완화/NNG;지지/NNG,25,5,30,4.5319040909908725,Hawkish
향방/NNG,251,166,417,1.3704914781189266,Hawkish
계란/NNG,11,7,18,1.424312714311417,Hawkish
만나/NNG,34,11,45,2.8015407107943573,Hawkish
이젠/MAG,11,6,17,1.661698166696653,Hawkish
취약차주/NNG,60,32,92,1.699464034121577,Hawkish
손실/NNG;우려/NNG,12,7,19,1.5537956883397277,Hawkish
하락/NNG;크/VV,50,31,81,1.4619045454809265,Hawkish
경기/NNG;하방/NNG;위험/NNG,37,18,55,1.8631161262962475,Hawkish
조정대상지역/NNG,20,7,27,2.589659480566213,Hawkish
무너/VV,173,91,264,1.7231195774536723,Hawkish
당분/NNG,17,7,24,2.201210558481281,Hawkish
궤도/NNG,104,70,174,1.3466229298944306,Hawkish
기류/NNG,53,36,89,1.3343939823473125,Hawkish
통화정책/NNG;경기/NNG;개선/NNG,18,3,21,5.438284909189047,Hawkish
세컨더리펀드/NNG,15,2,17,6.797856136486308,Hawkish
비축량/NNG,19,1,20,17.221235545765314,Hawkish
섣불/VV,29,20,49,1.314252186387353,Hawkish
링크드/NNG,23,5,28,4.169351763711602,Hawkish
축하/NNG,16,9,25,1.6113436767967546,Hawkish
안정성/NNG;강화/NNG,21,13,34,1.464153629397051,Hawkish
공급/NNG;제약/NNG,24,11,35,1.977558148796017,Hawkish
수요/NNG;압력/NNG,16,11,27,1.3183720991973447,Hawkish
원달러/NNG;급락/NNG,20,13,33,1.3944320279971913,Hawkish
주의보/NNG,25,15,40,1.5106346969969575,Hawkish
반반/MAG,275,92,367,2.7092904891793257,Hawkish
농기계/NNG,15,8,23,1.699464034121577,Hawkish
비용/NNG;인상/NNG,40,22,62,1.647965123996681,Hawkish
변이/NNG,121,52,173,2.1090784423457523,Hawkish
자기매매/NNG,26,9,35,2.618433474794726,Hawkish
상관계수/NNG,129,75,204,1.55897500730086,Hawkish
갖춰/VV,27,12,39,2.0393568409458926,Hawkish
산물/NNG,24,10,34,2.1753139636756185,Hawkish
이튿날/NNG,22,13,35,1.5338752307969103,Hawkish
최대/NNG;감소/NNG,18,9,27,1.812761636396349,Hawkish
수익구조/NNG,71,48,119,1.3406882935847997,Hawkish
고성/NNG,32,15,47,1.9336124121561056,Hawkish
과매도/NNG,101,41,142,2.2327917716589174,Hawkish
다다다/MAG,238,118,356,1.8281240231454703,Hawkish
cd/NNG;금리/NNG;상승/NNG,30,20,50,1.3595712272972615,Hawkish
버리/NNG,16,6,22,2.417015515195132,Hawkish
원화/NNG;환율/NNG;내리/VV,20,13,33,1.3944320279971913,Hawkish
역전폭/NNG,585,393,978,1.3491928209820154,Hawkish
공단채/NNG,890,529,1419,1.5249129077436205,Hawkish
당사도/NNG,16,9,25,1.6113436767967546,Hawkish
폭력/NNG,15,8,23,1.699464034121577,Hawkish
채권/NNG;매수/NNG;강화/NNG,11,6,17,1.661698166696653,Hawkish
신디케이트론/NNG,42,17,59,2.239293786136666,Hawkish
경제장관회의/NNG,26,12,38,1.9638251060960445,Hawkish
